ABRAHAM	ANABELLE	A
VINAS	MA.JOANNA	G
DELA.CRUZ	LUCILLE	A
GUZON	CHRISTINE	GRACE	R
BELISARIO	OMAR	SHARIFF	B
ELESORIO	EMELLIOLY	R
GARINO	JAMAR	P
QUIMBO	GLENN	IAN	T
ALGIRE	MAYRENE	D
LEUCH	KATHRYN	K
TENORIO	BILL	ADRIAN	S
LOPEZ	RENALIZA	E
DALANGIN	CECILIO	C	JR
TIRAZONA	LUDWIG	JOHANN	B
SUMAGUE	ELINOR	PAULA	D
DELFIN	AVICK	ROZ	A
TORRES	ARJANE	RONA	C
GONZAGA	LOVELY	JONNA	B
OCAMPO	JEFFREY	L
JUSAY	JENNETH	P
NITRO	JAEMIE	REAFORT	I
CHING	MARVIN	D
GADUENA	ALMIRA	LOU	O
VELASCO	PHILIP	VERNON	C
ALMEDA	RONANIEL	A
TONGCO	JOVALE	VINCENT	V
BASINGAN	MANOLO	L
CREHENCIA	MACELLE	M
RIVERA	MARTIN	ALLAN	I
AQUINO	JOANNE	ZOE	D
BANDELARIA	CAMILLE	S
RELLOSA	MYLA	CHRISTY	C
CASUPANAN	SANDY	LOU	C
MACALINTAL	MARC	KONRAD	M
SISON	FRANCES	RALPH	DL
TIVIDAD	JOYCE	V
TRAJADA	RODRIGO	JR	B
CABILLON-LAGASCA	YVES	CHRISTIAN	L
MANUEL	PRINCE	MARCIS	V
RACELA	HEATHCLIFF	SYLVESTER	U
HAO	ALDRIN	JOSEPH	J
ALAMAR	ELADIO
CALAYAN	KATHERINE	ANNE
SERRANO	KATRINA	CARLA	F
CARANZA	VALERIE	LOREN	B
PLATON	ROSCHELLE	M
REYES	MARIA	VIRGINIA	D
LECHUGA	JASMIN	A
ESTACIO	FRANCIS	LORENZO	E
CORPUZ	MARIA	CARMEN	A
SANCHEZ	LILI	MAE	L
PABLO	RUEL	A
JARENO	RODEN	JOSEF	S
ORTIZ	KATHLEEN	RUTH	R
URFANO	SHELLA	C
ZACARIAS	BERNADETTE	MELANIE	A
FERRERA	KATRINA	F
MIRABEL	KAREN	R
MAANO	WILSON	JR	R
BUFFE	CHARMAINE	C
ALBOS	SPENCER	M
FESALBON	RICHARD	P
CRUZAT	JAY	MARK	V
ALTO	TONIFLOR	O
BANEGA	JULIUS	F
SAN.MIGUEL	JAE	PAULO	C
VILLANIA	DAVID	III	V
LAZAGA	JOSEPHINE	S
TUANQUI	FRANCES	ANNE	C
CADIMAS	MAE	LAILANI	P
TYE	DAVIDSON	P
PANTI	ARVIN	B
BANIEL	ANNA	CARIZZA	C
ATIENZA	JANROE	RYAN	A
CANTOS	CHERRYL	M
RESURRECCION	ALEX	P
CATON	RICEL	ABA-KRIS	R
ALINSOD	KARLO	SANDINO	G
BOQUERENTE	CHRIS	LYNDON	T
SIMBAHAN	JOEL	ADRIAN	F
MENDOZA	KRISTEL	P
DALEJA	JONAH	LYN	L
MADRID	RIZALYN	D
MACATIAG	ARNOLD	ALLAN	L
TORRES	RONETTE	VALARIE	G
SANTILLAN	NIKKO	FERNANDO	O
FATALLA	KRISTINE	ANNE	S
ABDON	REIZIEL	VANESSA	E
TORRALBA	JUSTIN	DR
BALATAN	SIGFRED	JR	B
MANLOLOYO	THEA	YSOBEL	A
CUADRAZAL	JOHN	BROOKS	C
RUEDA	GINWENE	M
GASCON	ROXANNE	MAEVE
FIGUEROA	RACHEL	GRACE	B
TUATES	JAN	RODLY	M
REY	FRANZCER	MARVI	M
ALVARAN	LESLIE	ANNE
SANTOS	NELITA	A
TURINGAN	ARWEN	S
MARTINEZ	RONALD	R
FRANCISCO	FRANCESCO	RICARDO	CR
CAMUA	TIMOTHY	JOHN	P
LEE	MARK	PHILIP	B
NIEVA	MA.HELENA	D
TEVES	RONA	JANE	M
COLLADO	RENNE	CARLA	N
TIPON	MAVI	MARIZ	DF
HONORICO-LOPEZ	MA.LUISA	M
PONCIANO	ANDREA	J
PEREZ	JAMES	VERNON	D
JUNI	ANDRO	I
STA.ANA	ARDETH	HANNAH	V
ANDRADE	EDRALYN	LORENZ	O
CLAVER	ABYGAIL	B
BADONG	MAYFLOR	D
VIEJO	MARIA	ELENA	S
AYCO	RAMON	JR	P
DELA.CRUZ	CONRAD	ANGELO	L
SANSON	VANNA	KATRINA	T
OBANA	GERALDINE	LYLEE	C
ALUNING	RICHARD	CHRISTIENSEN	E
MACARAEG	LADY	RACHELLE	M
ROSALES	JOY	D
DOMINGO	DULCE	L
GALVEZ	VIDA	FAITH	R
GALAMAY	CHERISH	JUNE	G
MANGUERA	ANNA	ELLENA	C
QUIATSON	MAIREEN	T
ANICETO	PRISCILLA	MAE	C
LARCIA	HONEY	PATRIEZE	R
MENCIAS	BASIL	JOSHUA	S
NAHAR	SHAMDEE	N
FRANCISCO	NOAHDEL	HALLEL	C
VILLARAMA	GERRICK	REUBEN	M
SAN.DIEGO	MITCHELLE	S
GREGORIO	JOHN	CARLO	M
TOLOSA	JILL	AIRA	D
MARAAN	JOSELITO	T
LOZANO	ANDREW	NICO	S
PUA	CARL	ANGELO	C
SAYAO	MARIA	LORENA	D
MUNSAYAC	PETER	PAUL	M
MASANGA	ANNA	PAULEEN	L
GARCIA	GEMS	PAUL	C
AMATORIO	VLADIMIR	G
BONOAN	JEROME	AARON	C
DELOS.REYES	JAMIE	LYN	C
CONOR	AUDREY	CELESTINE	K
BELISON	CHRISTOPHER	ALEXIS	A
PENTECOSTES	KRISELLE	Z
RAMOS	JOHN	KARLO	A
ITE	MICHELLE	O
AGUILA	LOUIE	JOHN	A
NORA	JAN	DENNIS	O
GARCIA	JOHN	PAULO	F
MALIJAN	JOHANNA	BERNICE	M
RAMOS	MARIA	ESTEPHANIE	F
ENRIQUEZ	JOHN	PATRICK	N
MALABANAN	ARCI	JEICO	P
LUSTERIO	MARY	JOEL	L
PAMULAKLAKIN	MARIEL	P
DE.RAMOS	PAUL	RAINIER	M
FERINO	DANICA	ELIANA	C
MAGALLANES	FAYME	A
GARCIA	AISON	TRACEY	P
SALAZAR	ISAIAH	PAOLO	D
HABITO	JON	DOMINIC	DL
SAMONTE	MARIA	LOURDES	DT
HIZON	JOSEPH	CRISTOPHER	R
BATO	IAN	JONATHAN	D
ABRIL	SHEILA	ELEONOR	T
MANAIG	FORTUNATO	JR	A
LUGOD	ALEXIS	ANTHONY	T
MORENO	MANILYN	P
ARIDA	ARIELLA	H
LIT	JOSE	MARI	C
AGUIRRE	DONNA	MAE	S
VILLA	VINCENT	TROII	D
GAVINO	JENNILYN	P
BAYER	MC	HALE	P
ACEBRON	JUNE	QUEENNETTE	T
SATIOQUIA	KAYE	CARL	D
SUBIDA	ANGELIQUE	N
BILUGAN	PRINCES	PAMELA	R
RAPAY	ORLANDO	C
MARQUEZ	MARK	ARNEL	M
CASTILLO	SENEN	A
PIOQUINTO	IVY	T
RAYOS	KAREN	Y
AMUTAN	JOHN	JOSEPH	C
SUELO	CATHERINE	T
DIMAYUGA	CARLA	MARIE	A
MAGMANLAC	JONALD	R
DELICA	SANDRA	LYN	L
DIMAANO	ARVIN	JOSEPH	M
MANALO	CHARISSE	ANGELIQUE	B
CAPARROS	DAN	ANDREW	A
MACALINAO	RAYMOND	O
CONDE	LEI	DYNARAZADE	P
VILLANUEVA	OLIVER	M
GASGAS	LAURICE	C
AGNA	MARIA	MORIEL	O
RELENTE	CHRISTOFFER	EDD	N
VIRREY	KENNETH	GAIL	L
REGINIO	ARVIN	R
VARGAS	RONNEL	L
CARRANZA	FAYE	MADELEINE	U
REVEREZA	RIZZA	R
VALLE	PAUL	JUREY	V
SALVINO	EMMANUELLE	C
GAVIOLA	GHES	S
VALENCIA	GILBERT	DR
HEATH	CAROLYN	G
ROME	ROBERT	JULIAN	F
BARBARONA	RONA	F
MAGALONA	MARITESS	L
YBANEZ	QUINCY	E
SALINAS	JULIUS	CRIS	V
CARILLO	CZARINA	ELEANOR	A
JUSAY	JEREMY	DV
PATINDOL	MARK	REMBERT	M
DELA.CRUZ	LADIE	KIMBERLY	C
DAYRIT	JERIEL	LLOYD	F
LAPOOT	LLOYD	M
TALIPAN	CHERRY	MAE	S
MANUALES	PAUL	ANDREW	L
FAUSTINO	JON	PAOLO	J
ESPINA	BESSY	LOU	L
MOLDEZ	NATHAN	G
JUGAR	MICHAEL	JOHN	L
VILLARUZ	CECILLE	MARIE	C
ADAYA	ROULLETE	J
DELOSO	JESSIE	LORD	A
TATEL	REYMUND	D
DIANSO	IAN	JOSEPH	M
MONROYO	MIKAEL	EDWARD	M
GADO	JERIC	G
DE.LEON	MAR	ANGELO	N
SALDAJENO	IVAN	STEWART	B
CASTILAN	MARK	GABRIEL	D
BEROT	RONEL	T
SAMSON	MARIANE	THERESE	F
TAULE	LAUREN	MARIE	B
GATACELO	STEVEN	G
MENDOZA	MARIA	REGINE	G
CABUGAO	ALEX	ROY	G
GATCHALIAN	ELIZABETH	S
ESCOBEDO	ERICSON	G
NATIVIDAD	DARRYL	KIM	C
CACERES	EMELINA	N
BOONGALING	MELIZA	B
SAN.AGUSTIN	DAN	AZRIEL	N
PARAS	JOAN	ABEGAIL	D
SANTIAGO	ROMEL	L
SOQUENA	EVA	MARIE	V
CAPUCHINO	MARICEL	M
MACAPULAY	JEMMA	MARIE	A
PAZ	JONATHAN	V
GARCIA	JENNIFER	A
ILAGAN	ANA	VICTORIA	DC
ACABADO	JENINA	JANE	V
FALZADO	REYNALD	ANDRE	M
ULLADO	BENEDICT	C
ADVINCULA	ROLAND	P	JR
SANTOS	ABRAHAM	FINNEY	I
MARQUEZ	KEVINILO	P
CRUZ	JASON	ERIC	S
NAVARRO	CECILIA	M
MARQUETA	DARYL	S
CACAYAN	JENNIFER	C
MENDOZA	ODELLAINE	LOU	M
ADRIANO	JED	MATTHEW	R
CABUYADAO	ADORA	ALEXIS	B
PEDREGOSA	JOHN	ELWIN	G
CASIGURAN	RICHARD	B
SANGALANG	BRIAN	RAE	B
SERAFINES	REGINE	JOY	H
PATRON	ABIGAIL	M
LUNA	MONALIZA	A
CACAO	MARY	JANE	C
CRUZ	KARL	KELVIN	V
VEGA	MARA	JANINE	H
SISON	AYANA	GRACE	T
SATORRE	ELAINE	MARIE	B
AGULLO	NOEL	MARLU	A
NARAG	JANEL	MARIE	M
MARQUEZ	MELISSA	RHONA	L
TARUN	KATRINA	B
REOMA	JHANEALLE	PRINCESS	F
VEA	STEPHANIE	P
BARRION	LOUIE	B
STO	DOMINGO	RODELYN	M
HALILI	RACHEL	ANN	R
MATEO	JOHN	MARTY	C
ROXAS	GRACILE	CELINE	T
MARASIGAN	JOSIAH	J
DELA.CRUZ	RHEALYN	T
MARQUESES	BEA	CHARIZ	P
CRUZ	ANGELA	MAE	S
FABIA	FERNANDO	JR	D
VIRGO	SHIELA	MARIE	D
TORRES	JOHN	MARK	K
BASILIA	MERJIM	B
ROBLES	STEPHANIE	HAZEL	F
ONG	MARIA	KATHLYN	V
PADILLA	STEFFI	JOY	C
CRUZ	CARSON	JEFFREY	O
GARCIA	JOAN	DENISE	DF
YUSON	JEAN	MICHAEL	G
DE.LEON	NIKKO	C
MANGA	MA.DOLORES	M
BAUTISTA	FELIONA	B
OCAMPO	RODEL	JR	R
LAYLO	HERLYN	MAE	Z
ROBLES	LAURENCE	E
ABCEJO	IVANA	MARIE	S
NOGUERA	LEA	FEMINA	G
BERNARDO	JUDITH	M
APLACA	JESSELLE	T
DADIVAS	PRISTINE	ALEXIS	G
DAMALERIO	MAY	FAIR	L
REYES	JUDE	PATRICK	V
OPANO	RIVERO	P
YANOS	ADONIS	A
SARMIENTO	CAMILLE	ANNE	A
LASTIMOZA	RACHELLE	C
BORROMEO	KIRK	ERVIN	D
NAPA	DAY	YENTLE	D
EUSEBIO	MARK	JULIUS	F
BAUTISTA	RAFAEL	A
DOMINGO	KRIZIA	MARIAE	DC
MACALISANG	AILEEN	B
FELICIANO	JAZMINE	ROSANNA	P
SIM	MARINELLE	C
MENDOZA	FRANCES	GRACELLE	Q
PADOLINA	CHRISTIAN	CARLO	T
LAGO	JETHRO	P
ARGUELLES	KATRINA	JOY	E
CASTILLO	ABIGAIL	E
MALABANAN	MARITES	V
SAPASAP	MA.VERONICA	DG
PELEO	MARIVI	C
DANGATAG	CRISTAL	ALEXIS	M
SARACANLAO	ROCHELLE	JOIE	A
DOMINGO	BON	JORELLE	M
CALALANG	RACHELLE	C
FACTOLERIN	KAILA	MILOS	C
PAYOYO	NINO	BEN	C
ABELLA	JEREMIAH	P
GARCIA	KEENE	OMAR	M
RAMOS	CIELO	CHERRYLANE	D
SENIQUE	JAYMOND	R
TIBAYAN	EVY	PRINCESS	C
LOZADA	DENNIS	NICUH	B
DE.GUZMAN	DONNA	FAZ	C
MALLARI	RHEA	DC
SANTIAGO	MARY	GRACE	L
LUCERO	JANELLE	WINLI	B
VALDEZ	PRINCESS	T
ESCALONA	JESSIE	M
MALAZO	JOEL	VEN	S
MANALASTAS	JESSAL	C
BONITA	MARIA	LORENA	M
ORIAL	ROLI	ALEXANDRA	N
TAMURA	HEISSEN	JAMES	H
JOPIA	FE	MARIE	C
MANGLICMOT	MARIDANNE	P
PALAJE	MIRRIAM	JOYCE	M
MALABAD	JOHN	CARLO	M
DACALAN	MA.ANTONETTE	M
VILLANUEVA	CHRISTIAN	KENNETH	C
BERTULANO	JENNILYN	L
ESPIRITU	MARIE	KATHERINE	B
GOMEZ	JAYMIE	SANDRO	R
LIWANAG	MARIYEL	HIYAS	C
MENDOZA	EMMARIS	JANE	O
NANO	ELLEN	A
ROTAP	JUSTIN	RAY	R
ROXAS	GIANNE	MARIE	H
SAMSON	JOHN	KEVIN	C
TUAZON	RICHELLE	ANN	M
VILLARUEL	AURA	MAE	B
ALEJANDRO	AYR	AINNIE	D
PENDON	FERDINAND	C
LIBRES	EDEN	MAY	G
BAUTISTA	JOHN	ALLEN	V
MAMPUSTI	ZSEREENA	ROSE	A
JUCUTAN	JOYCE	G
CHAN	EMMANUEL	PATRICK	M
VITTO	JANINE	KAYE	G
IGHARAS	DONNABEL	C
TENERIFE	LUIGI	MARI	B
BRACEROS	JANN	DENISE	A
GONZALES	SARAH	JANE	T
DELA.ROSA	BRYAN	LLOYD	L
QUIJANO	MERLIN	BECKER	B
SAPLA	GLENN	ALLEN	B
FIDELINO	MARIA	CRISTINA	F
RUETAS	ELIZABETH	D
RESURRECCION	HYSONN	U
DE.LIMA	ANNA	JANE	DC
DELA.CRUZ	NINA	MAE	L
FORONDA	JANIZA	LIANNE	M
MAMACLAY	NORIELL	JONATHAN	M
ESTORNINOS	MARLIT	A
PALMA	PAT	SUZANNE	S
FERNANDEZ	DESAMARIE	ANTONETTE	P
AMONGO	JAN	MARION	C
CALUB	PAUL	AMBROSE	C
QUIMBO	GIL	JOSEPH	DJ
GARCIA	FELAN	CARLO	C
MARAVILLA	VEA	MARIE	M
AMBULO	JOHN	PAULO	P
DACARA	JODEL	EFFIN	C
ALDOVER	CZAR	LIN	H
OCAMPO	ALLYN	ANTONETTE	P
GARDON	TISA	KORINA	L
AMISCOSA	MONINA	FAYE	L
CULAWAY	RENEE	JUNE	C
LOJO	MARIA	JEZZA	T
DANAS	JENICA	SHANE	S
CAOAGAS	CATHERINE	B
VILLACORTA	CARMELA	ADA	T
GATBONTON	CRISTINA	AMOR	C
POLLO	BERNARD	ANDREI	LV
FOJAS	IVAN	MATTHEW	M
CANTOS	JOAN	REINA	L
PERDIGONES	BEGIE	C
SAQUILLO	CHRISTOPHER	R
SANTOS	DARREN	ALDRIC	O
DIEGO	ERICA	JANE	M
PATAG	KRISTINE	JOY	V
BARTOLOME	AYLIN	C
GARCIA	JUSTIN	IVAN	A
VEGA	GINALYN	V
ORTEGA	DANIEL	CAESAR	U
BORGONIA	PEARL	ANNE	B
MADANGUIT	BENEDICT	L
SANIDAD	ELLAINE	JOY	C
DAYAG	KATE	ASHLYN	N
SINGSON	CAMELLA	THERISE	T
RIVERA	RAFAELA	ANNE	P
ORIG	ANNA	MARIE	DC
LUTERO	DESTINY	SM
ACLON	KRIZILL	JANE	M
REYES	ODESSA	V
OROBIA	KEISSY	MARIE	C
MARASIGAN	REYJONDEL	D
UMALI	APRIL	JOY	B
DIALOLA	NOEMI	F
BELGADO	MIKO	LORENZO	J
VILLAPANDO	JUMAR	DQ
LABRO	FRANCIS	KIEV	D
CORPUZ	BELMAN	R
ONATE	SHERLYN	A
RAMOS	NIKKO	ANGELO	Y
ANONUEVO	OG	WASHIL	F
GARCIA	JOEMIL	A
SALCEDO	MICA	REGINE	C
ZARSADIAS	ZINDEE	IRA	O
GUDOY	VINCENT	MAVERICK	U
SALTA	SAIRAH	KRIAH	L
DELA.CRUZ	ANNA	MARIE	S
BARACAO	MARK	VINCENT	G
VASQUEZ	MARIA	SALVE	C
ZAPANTA	CHRISTIAN	DAVID	A
BALITAON	AHL	G
CONSTANTINO	NINA	LANIE	C
BONGON	PATRICIA	BIANCA	C
ALLANIGUE	DIANNE	KRIZZIA	A
ARAYAN	LAURICE	T
ZARATE	ROLAND	CHRIS	N
BISNAN	NICO	L
LADRERA	CHERRY	ANN	P
GUINO-O	GAVRIELYN	R
MARIN	SABRINA	E
AMBOY	MARIE	ASTRID	C
PAJARON	JENILYN	D
BUEN	GUENDILYN	H
LIMBAUAN	MA.THERESA	B
BROSAS	JEWEL	V
ANGARA	MARCO	ANTONIO	A
SOTANA	ELMER	C
RAMOS	ARMAN	JAMES	D
AQUINO	VRENNELI	F
ALMEDA	MARIAN	GRACE	B
INCIONG	MARK	ANTHONY	C
CANTELA	MARRA	MONIQUE	S
NEVADO	JOSEPHINE	B
VILLANUEVA	MOSES	O
VISCA	SHEILA	KRISTINA	T
MANALILI	LES	M
DICTADO	RENZ	MYKELL	A
MEDINA	EDFER	C
CABAYA	LARA	VEY	C
NAGUIT	ANDREA	L
FELICIANO	CASSANDRA	R
ALFONSO	ANNA	PATRICIA	C
BARRIENTOS	MARI	ANGELA	R
ESCOBAR	LAUREN	ANTHONY	L
TORRALBA	DARYL	STEFFANIE	G
MALDONADO	MARYANN	M
SORIANO	JUAN	PAOLO	E
CRUZ	MERYL	B
DEIMOY	JOHN	ROY	R
CASTILLO	LAURENCE	MARVIN	S
DELGADO	ELOIZA	LUZ	D
GARCIA	LESLIE	ANNE	G
CHAVEZ	EUNICE	B
LIWANAG	IRISH	D
CHAN	MICHAEL	C
SUNGCAYA	AILYN	G
CRISOLOGO	JOSEPH	ALEXANDER	G
AVES	REYNALDO	BERNABE	E
GARCIA	ISABELLE	M	C
SIMBAHAN	ARIANNE	F
VERGARA	GIANINA	RENEE	V
SENETE	CHARLENE	T
PADUA	JENNY	ROSE	S
MANSET	LANY	O
CONCORDIA	CHERRY	MAY	C
DUARTE	ROMER	L
DE.VILLA	ARCHIE	V
MEDRANO	HAZEL	L
TUPAS	MELIZA	MARIE	A
CARADA	MIRIAM	CARYL	DL
MALABUYOC	DON	JURRAINE	S
PASCO	RICHARD	M
RUAZOL	DENISE	ALLYSON	C
CERDENA	KARLA	IRIZA	R
TENGCO	MARY	ROANNE	M
MOLINA	ANDREA	KRISTINE	G
PASAHOL	CAMILLE	S
SIMON	KRISTINE	V
NAGPALA	ALELIE	C
MACATANGAY	MARIA	GELYN	B
MUYCO	PAULA	GRACE	M
SARMIENTO	DANIELLE	ANNE	M
GARCIA	HANA	PHYLICIA	T
BALATIBAT	EMILAINE	M
TAN	MARY	GRACE	D
SALGADO	MA.CAMILLE	B
STA	MARIA	ANGELIQUE	S
BIEL	DARAHLYN	M
PAITA	CONSORTIA	ADELWISA	M
MISOLAS	EMMANUEL	B
PUNAY	RAYMOND	A
ACERO	BART	JR	L
REYSOMA	RAPHAEL	ALAN	C
ISLETA	LADDY	MHAY	M
VILLA	ELTON	S
REYES	MARINELA	C
ATIENZA	ROMELYN	D
ALMENDRALA	ZANDRO	R
JADIE	FRANCIS	XAVIER	A
FALOGME	ROLAN	KENNETH	SP
PUNO	ARIEL	DR
CANLOBO	FRANK	DANIEL	A
DE.LEON	JOHN	NIKKO	R
APACIONADO	ROBEROZA	DV
GALANG	MARY	ANGELIQUE	G
SIA	FLORENCE	ANGELIE	C
GAMBOA	JAN	DHERICK	N
ARCUERES	DEANNA	ELLI	U
CANOY	ELEONOR	CHRISTINE	M
MALIXI	JERNELL	ROBERT	D
CLABITA	MICHAEL	ANGELO	A
DESEPIDA	ESTHER	AILA	B
JAEN	ESOBEL	D
RABINO	ALYSSA	MARIE	R
BARRIENTOS	CHERRY-ANN	N
ALVARADO	MARIELYN	O
URZO	REA	ETHEL	A
ALMONTE	JEZREEL	R
DEVOMA	REYMARK	Z
CONSIGNADO	KRYZA	I
CENTENO	CAESAR	ARLOO	R
JAVEL	JERWIN	L
MATIENZO	MA.AIRA	O
PEREZ	BETHANY	GRACE	R
PALMA	CLARICE	B
FORTES	RAYNAMARIE	T
TULAD	JENNY	A
CAPACIO	SARAH	JANE	R
BUENCILLO	ALDRINALD	D
CALALO	ABEGAIL	CHARLENE	C
CALIBO	NEIL	V
DE.JESUS	MARIA	KATRINA	G
PECOLERA	RUTHLYN	S
MANGIO	FRANC	JERONE	R
MARASIGAN	GLEXTER	S
AGUITEZ	UNICA	NINA	L
BONILLA	GLYNNIS	LYNN	U
CASTILLO	BERNADINE	V
MONTEFALCON	MA.CZERYNA	S
PANGUE	ELLENROSE	MARIE	U
QUIAMBAO	SHIELA	CAMILLE	G
SALAMAT	SARAH	S
REALON	LEA	KATRINA	R
ALVARAN	JERONE	ALAIN	S
DAMASK	MEREDITH	KAY	R
DELGADO	DANILO	JR	A
DORADO	JOHN	ALDRIN	D
GUIA	RIALPH	ENGEL	D
PAJE	FRANCIS	MICHAEL	F
BACAY	MARIA	ANN	E
METICA	FRANCES	G
DE.ROMA	KRISTLE	ALINE	C
BONGOLAN	RALPH	R
BUSTONERA	REGINE	G
COCJIN	GIDEON	III	T
ALCAIN	ALISTAIR	MARIE	H
VALINO	DARRYL	ANTHONY	M
COLLE	MICHAELA	T
RIANO	KERK	AUGUSTINE	C
MONSERRAT	MARY	ANN	D
DE.MESA	MARIEL	M
FULE	MICHELLE	G
CERVANTES	JESSE	C
PONCE	JENAZIEL	MARIELLE	R
TORRES	FATIMA	M
FERNANDEZ	JEDDA	O
ARGETE	AIZELLE	YEN	S
LAWAS	MARIA	CARLIN	B
AGUILA	MARIOLE	ANGELINE	DT
ALVAREZ	PAUL	LLOYDSON	J
FLORES	MARK	PAUL	D
REDONDO	ANGELA	L
ELEVERA	KENNELYN	B
EXCONDE	HIDEMI	D
NAANOD	GENE	REIZ	K
GRANADA	DAECHEL	DARA	A
PALO	JORDAN	JENNIFER	S
PADOLINA	ARON	S
RENDON	MARIANNE	DM
ANGELES	JOANNA	MARIE	DP
GARCIA	MARK	ANTHONY	F
MEDRANO	JULIE	ANN	C
GUEVARRA	MARICRIS	C
VALDEABELLA	MARA	SHYN	M
FALCUNIT	DIXIE	JR	F
ARBAN	ALNIE	MARIE	D
QUINTOS	MARK	ANTHONY	M
MUNDOC	ERNA	JESSA	E
LIRIO	ALVIN	E
GABANE	PAULO	GENESIS	S
PALMA	ANA	ANDREA	S
NOVILLOS	ABEGAIL	S
MALAHITO	JOHN	ARIES	I
VILLOTA	GIAN	PAOLO	M
DELA.COSTA	LOLLI	MAE	O
GELVEZ	KIMBERLY	ANN	M
LAZO	PROMETHEUS	PETER	L
TANCINCO	JERICK	MARI	A
REDONDO	MARIE	JEAZELLE	H
MAGBITANG	EMMA	PERPETUA	A
PASTRANA	DAVIDSON	V
LATORRE	MARY	MORRIEL	G
CEDICOL	NIKO	C
PALANCA	JOSEMIAE	MUTYA	F
RATILLA	PAOLA	CRISTINA	P
SAMANIEGO	RAFAEL	P
ALEJAR	MARIA	ISABELLA	B
CUADRA	ALYSSA	JOYCE	L
MOVILLON	JONATHAN	DAVID	L
PERALTA	ALBERT	GEOFFRED	B
VELASCO	JOYCE	ANN	V
VELECINA	VERNIE	B
ALLER	JAZMIN	JILL	G
ALONZO	CHRISTINE	AZALEA	B
CAROLINA	NATHANIEL	T
MANZANILLA	DUANE	RAPHAEL	O
MARCAIDA	POLA	CARMELA	E
MATIAS	ALYANA	ELLAINE	S
BERNARDO	REUTER	KING	M
LAZARO	JANINA	A
PAMATMAT	MARIE	FRANZE	C
VILLAMOR	KAMILLE	ANGELA	I
BANTATUA	CARELLE	GRACE	P
ARZADON	EUNICE	L
OCAMPO	JOHN	LOUIE	DC
TANDANG	VIENNA	B
LEE	DA-YOUNG
GENDRANO	EDMAR	D
DE.MESA	DANDIE	O
DELA.PAZ	IRENE	CAMILLE	P
BRADECINA	JOSEPHINE	RAZIL	V
AALA	WILSON	F
CATAMIO	ARIES	S
JAURIGUE	MARLON	A
MARFORI	RUDOLPH	JOSEPH	S
GAYAHAN	ALLAN	KIM	V
MAGBANUA	DIANA	MICHELLE	DR
ARCEO	JARA	CLARIZ	DL
HADAP	ELAINE	G
GAGUAN	MARY	ANN	P
MANGAYA	CINDY	T
RAYMUNDO	MARK	DEAN	S
ORENCIA	MARK	STEPHEN	N
VEDAD	JAYSON	DR
YA-ON	WINIFREDO	JR	N
BUNGAG	MYRA	G
DIEL	APRIL	C
ISRAEL	WALTER	KRYSTLER	DC
BAUTISTA	REBECCA	D
AGAID	GLADYS	E
AMBAS	REAH	FLOR	M
NAMORO	DAUGHNILEN	G
TANADA	JOHN	PETER	N
ABAINZA	MILAFLOR	T
CALUGAY	ZARINE	B
RIVAS	RALPH	MARTIN	S
PANGAN	IRIS	DAWN	L
ESGUERRA	SARAH	S
ADDAWE	EVAN	GEORGE	C
GONZALES	MANUEL	GASPAR	A
ZAMORA	LIZA	R
MONTOJO	CHERRY	ROSE	M
CABERTE	KRISTINE	E
ARCILLA	JINKY	JANE	A
SANTOS	SAMIEL	GERARD	C
CANO	ANNA	ALESSANDRA	G
WONG	RAYMART	V
SANTIAGO	FER	ANGELINE	C
DEFENSOR	JIANA	DENISE	G
RIVERA	AIZELLE	A
CASTRO	ANYZZA	DC
OBRERO	WENCY	JOY	DS
ELEFANTE	ROSELLE	A
URQUIOLA	EMERALD	RUBY	L
FERNANDEZ	ROBENIE	D
OCAMPO	FARAH	MARIZ	L
CRUZ	EARLVYN	JOY	A
GERON	PRINCESS	JOANNE	F
LOPEZ	NADINE-JELL	C
TUAZON	FLORIZA	BIANCA	L
MALLORCA	GILMERI	PEACH
CERDENO	RUBY	C
BERNABE	MARK	LESTER	C
BAUTISTA	JAIMIE	CRISELLE	S
GALVEZ	GENEVA	M
DEMAISIP	MA.GERARDINE	N
DE.LEON	DEONARD	P
SARCIA	MARCEL	M
BAYLON	ARA	JENIKA	A
JALOSJOS	JHON	JORDAN	N
PEREZ	CORINNE	IRENE	A
HISUG	HANNAH	MARIE	H
SIMON	ALVIN	NOWELL	P
SORIANO	AIVY	A
SALDUA	MELANIE	L
MANGANTANG	KHAREN	E
PREMNE	PRIME
LIM	ANA	KRISTINA	P
GONZALES	KATHRINE	A
DEL.MUNDO	MAYEN	B
MANINGAS	ANNE	MEAGEN	DC
GACILA	JEAN	C
MAGBOO	MARIE	LOUISE	M
CARMONA	MARIFE	B
ARICAYA	CHINO	CARLO	U
CERO	AMYEL	DALE	L
DELOS.SANTOS	KATHRINE	AIRA	N
LAGAHID	KAYRA	LIANNA	S
LAPITAN	JAECEL	REYENNE	L
MALIMBAN	HONEY	MAE	R
REYES	CHRISTINE	C
CANTOS	CHRISTIAN	F
BATINO	RYSA	ADORA	T
ANDAM	FEBRINA	ROY	D
GARCERA	AILEA	KATHLEEN	A
GRACILLA	MARIFE	E
GUERRERO	IDA	LOUISE	M
GAVILAN	JONA	GLORIANNE	B
MATAAC	MAE	LAARNI	F
CALVO	YBA	DILLA	S
VILLANUEVA	MARK	JASON	L
CATIMBANG	CYRUS	V
GARCIA	ARREANE	EARL	B
CASADA	CYRUS	VENN	P
LEVINA	FAYE	DR
DE.GALA	CHEEZED	Z
SUBALDO	FRENZ	VON	L
DENIEGA	FROILA	MARIE	G
GATAN	CASIE	NELIA	F
TAN	HANNAH	PAMELA	D
CELES	MA.ANDREAH	D
MOPIA	KARL	MOSES	B
DETERA	ROCHELL-MAE	L
FALLAR	REN	CARLO	R
GERONIMO	MARIFEL	S
MATIC	ALEXANDRIA	E
ESPIRITU	MERVIN	RAY	V
DAYAON	DIONNE	FRANCE	B
LABONITE	LAILA	M
BOLLOSA	RHODA	VANESSA	P
ADANTE	ROSELLIE	R
BALUYOT	ALEXIS	ANNE	DC
HULIPAS	DANIEL	JOHN	S
SUGUITAN	JET	G
MALIHAN	JHUDIE	ANNE	V
LUIB	JAYSON	ROMEL	A
CAPINIG	AUBREY	MARIE	F
LEGARDA	ALEXIANNE	MARIE	DP
DIZON	HAZEL	Y
CLADO	DONNA	OLIVIA	M
LANZADERAS	CRIS	R
BARROGA	MABEL	I
GALABIN	FORTUNATO	III	L
VENTURINA	DARYL	JOHN	A
RECIBE	AUDREY	N
HABAN	MARC	ARTHUR	T
CLARIDAD	JOHN	ROLAND	Q
DE.LUNA	LAURA	JOY	A
GRAPANI	JULIE	ANN	M
MENDOZA	ANGELICA	B
IGNACIO	CHRIS	ELIZHER	D
ROBLEZA	REZA	ANGELICA	R
TUMAMPOS	STEPHANIE	B
GAMIL	ALMOND	CARLO
DE.LEON	JOHN	JONEL	DC
DE.CASTRO	ARIANE	PAOLA	D
BERMAL	LARA	JILL	H
MAYUGA	GLADLEE	D
FABREAG	MELODY	R
COMIA	LUSIELE	L
MAYOR	BRYAN	A
AQUITANA	LEA	ANNE	E
LORICA	MA.IRENE	M
EBORA	MARIBEL	A
BANAAG	MIANN	S
LOPEZ	MARIE	JOY	F
BUELA	MABEL	S
OLAYER	FRANCESCA	CARLA	V
ASIS	MARK	ANGELO	R
TANDAYU	ERWIN	S
SOLIS	NIKKI	L
TESORERO	ALVERN	P
FIDEL	LIZA	MARIE	S
HUGO	EDISON	D
RELENTE	MARVIN	JOSEPH	D
BARRAMEDA	SHARENE	F
JUARBAL	RAJIV	R
ZARRAGA	NINA	ANGELA	C
CABULONG	RHUDITH	B
CORTEZ	AARON	PAUL	A
LACSAMANA	JOANNE	KRISHA	M
SALES	KARLA	NADINE	D
COLLERA	MYLEEN	DP
GONZALES	GIRLIE	R
APOSTOL	AUBREY	GLANCE	O
BRIONES	ALEXIS	B
ARIATE	JEANIELYN	G
GABILO	KERVIN	O
ACAR	MA.VICTORIA	T
CASTRO	FRANCISCO	V	G
LIMOS	MELANIE	JOY	C
PAGAYON	RIZA	MAY	P
TAGUINOD	JULIUS	EVAN	R
MAGSINO	AL	JEROME	A
JUNIO	ERIKA	SHANE	C
MILITANTE	JOSE	III	C
CONEL	EDWIN	B
PADERES	KRISTINE	JANE	M
ESPIRITU	FELY	M
RASCO	JUNA	FRANCES	Z
COLLADO	ERIKA	C
ALCOS	CHARISSE	D
ESTEBAN	YHANCO	T	II
TORNEO	PETER	PAUL	R
ABISADO	RHONA	G
GALAROSA	ELLEN	F
MARTILLANA	MA.REBECCA	N
REPOTENTE	APRIL	ANN	N
VILLANUEVA	MARIVIC	S
MANUEL	MICHELIA	T
ENTICO	ERIKA	MAE	A
DOLOIRAS	SARAH	MAY	L
LASAM	JOEL	MARTIN	R
NAVARRO	ADRIAN	DJ
GALAN	LEAN	D
PERIODICO	TRISHIA	JAN	B
LORICO	LINDELLE	S
ABUEL	KRISTINA	ISABEL	R
SALUDARES	MARK	LOUI	D
NANTES	MYKKAN	S
GAFFUD	ALTHEA	DC
ORIA	PRESCIOUS	ANN	S
OBUNGEN	GISELLE	LP
DAGANTA	MARK	REY	A
DELA.CRUZ	BEN	PAUL	B
RUIZ	ANGELINE	C
DEL.CASTILLO	KARIS	LEE	M
VILLAFLOR	RENIEL	A
VELASQUEZ	JONATHAN	EMMANUEL	G
RICO	CHRISTIAN	IRENE	J
SAN.JUAN	UJANE	DLA
TOLENTINO	MALCO	O
TORREFIEL	MARY	AIZA	A
SIOPONGCO	LUKE	JEREMIAH	B
LOBO	KRISTINE	GAIL	C
DELA.ROSA	HEIDI	M
OLOC-OLOC	NIKKI	LAUREN	C
ENRIQUEZ	SARRAH	MARIE	F
TANIEGRA	ROMMEL	M
AGUILAR	FRANCIS	A
MANALO	KAREN	PAULA	V
CHUA	HAZEL	MARICE	O
TAPIA	RONALD	R
VILLADOS	NADINE	THERESE	C
SO	MERIAN	T
TORRES	DIEGO	GABRIEL	B
REYES	MIRRA	FIDELIS	V
SALAMAT	SAUBEL	EZRAEL	A
MOTA	ALVIN	ROY	A
MANALO	CLARICE	M
REYES	PAMELA	GELYN	T
LIWANAG	MARLO	EDEL	C
CANASA	JOSEPHINE	ANGELA	DG
BALINO	KRISTEL	MARIE	H
BASINILLO	VALERIE	MAE	A
SAAVEDRA	ANNE	JANINE	M
HIDALGO	ERICKA	JANE	C
SERRANO	ARC	SHEEN	F
FANO	STEFFANIE	F
OLIVA	FREDDIE	JR	L
PAGULAYAN	AERON	PAUL	V
TAN	DENIJEZ	GABRIELLE	B
MELLA	MARYCON	CARMELA	G
LASCANO	ROYCE	ANN	A
HILADO	SHENIE	A
MANINGAS	MARY	JOY	P
PAJE	ANDREW	NICOLE	G
GABRIEL	SARAH	SHARMAINE	T
PAGUIRIGAN	NEALE	MARVIN	C
DUAG	MARYVYNNE	G
TIERRA	MARK	CHRISTOPHER	S
CESAR	PATRICIA	MARIE	S
ARNEJO	ZENITH	O
GAPUSAN	JUSTIN	CHRISTOPHER	S
ICBAN	HELEN	GRACE	V
CRISTOBAL	MICHELLE	S
SUMAGPAO	JOY	LEEJAH	M
DELAS	ALAS	MARK	ANTHONY	C
INVIERNO	IAN	DAVE	C
VALDEZ	KATRINA	CONCEPCION	S
BELTRAN	ROSE	MAY	Z
GUANZON	JUSTINE	JESUSA	G
ROSALES	ELYSSA	CLARISSE	A
RUSTIA	CHRISTYNNE	JOY	M
RIVERA	REY-ANN	B
ARAMBULO	ZURIELE	G
ROMERO	MARLON	O
SEVERO	JOANA	MAY	R
DEFENSOR	KIM	EMMANUEL	C
JESUITAS	MILLEN	REGINA
BULAUN	GRACE	G
SALIDO	FELICE	MARGRETTE	I
PASCUAL	ERMAINE	D
RUFO	JANINE	RIVA	O
BANACIA	REGELYN	T
LOPEZ	FRANCHESKA	BEA	M
CARINAN	SHERYL	KAREEN	P
CAPILI	KATREENA	GABRIELLE	G
VILELA	JULIANNE	A
ESTEBAN	IRENE	VEE	O
JARANA	ANNALHEA	P
LLIDO	MARIA	THERESA	C
BARGAYO	ANNAMAE	G
DIOQUINO	LEI	ANNMARI	P
HILARIO	EZEKIEL	R
FABROS	JULIAN	PAOLO	T
PERNITO	ARBY	J
NOTARTE	LIBERTY	A
OGRIMEN	RHODORA	DG
AQUINO	MA.FRANCESCA	B
ODSIGUE	DAVE	MICHAEL	A
PAMITTAN	FELIX	LAURENCE	A
VELOSO	REYA	MARI	S
UMALI	REGINA	ESTER	DC
NARANJA	KIMBERLY	ANN	A
REYES	MA.BERNADETTE	M
DE.PERALTA	JENE	RUEL	G
CUARESMA	DIANE	CARMELIZA	N
MATIAS	KAREN	KAY	C
ESGUERRA	ANNA	BETTINA	A
BALITE	PATRICK	HARRY	M
RIVERA	KATHLEEN	KATE	A
CABRERA	FERNEL	GREGORIO	C
GARCIA	KATHRINE	YVETTE	L
VIVAS	PHOEBE	JEAN	O
HERNANDEZ	XEREZ	VERA	V
SANDAGON	FRANCES	DONNABELLE	C
CARDONA	DON	EMANUEL	M
SOLANO	ANDREI	KLAISE	P
ANTIPALA	YNA	ALTEA	DP
CATIBOG	KRISTA	MAYE	D
GUEVARRA	SARAH	LUZ	A
PAELMO	JEZMHYN	MARIE	R
DELA.CRUZ	ALLEN	D
BELAGUIN	CHRYSS	ANN	A
MARANAN	NEICII	KEROLAINE	T
VELECINA	MA.JAMELA	O
ROGANDO	RACHELLE	C
DESEPEDA	CASELYN	S
DECANO	SUZANNE	M
ALEMANIA	RENZ	MARION	M
MALACAMAN	IVY	MELISSA	G
SORIANO	STEFFANIE	L
DAVID	DAWN	MARISSE	B
TIEMPO	JUAN	CARLO
GERTES	CARLA	H
DOTE	JIELLE	ANNE	G
FERNANDO	GELYN	JOY	M
CABUROG	MARIE	ANNE	R
EBINA	DAVID	ANDREW	A
MORES	JEMARJO	L
PIOL	JERMAINE	DESIREE	S
SILANG	KRISTEL	JOY	M
HERNANDEZ	JOHN	PATRICK	B
PROTACIO	PAUL	DAVID	A
MACASAET	DANIELA	MARIE	A
DOMINGO	LEI	ISABEL	S
CAMBEL	RAMONCITO	G
ELAURIA	KATRINA	C
BARAJAS	JOHN	RICHARD	B
GAZZINGAN	MELISSA	A
CONDE	APRIL	KARLA	N
GARCIA	MATTHEW	SOLOMON	S
GONZALES	JELVILYN	REINNA	DR
PINEDA	ANGELICA	FRANZES	D
VACARIZAS	JANICE	N
SALAZAR	SHERRY	LYNNE	B
AJES	ERIKA	THEA	H
BERMEJO	APRIL	O
DORADO	CRISTINA	A
MALENAB	KRIEZL	IVES	T
OBRADOR	JONA	RAE	S
JUACALLA	BIANCA	MARIEL	DP
CUPON	MICHAEL	VINCENT	G
MOGUL	RAYMOND	T
PEROLINA	FAOLA	RACELIN	R
LALONG-ISIP	MARIA	MELISSA	T
GATAPIA	UDILEAN	M
QUIBUYEN	RICHELLE	F
BONZA	MARJONIE	B
PANERGALIN	MARIA	IRENE	P
DE.VILLA	MA.CLARA	M
JOVES	JACO	R
MARIANO	NINA	ANNA	C
LAVADIA	CORAZON	ADELE	F
HERNANDEZ	KATLEEN	ANNE	C
ROSALES	STEPHANIE	N
MERCED	MARY	ERICCA	S
ANGUB	MARIA	CECILIA	M
PEREZ	JUVENEIL	EISSYD	J
BAGSIC	TYRA	JANE	M
TOLENTINO	GLALDYS	ABIGAIL	A
DE.GUZMAN	CARLETH	JOYCE	R
ALAYON	JEWEL	S
ADONA	AILEEN	CARLA	G
MARTINEZ	JHUCY	ANNE	DC
ELOMINA	KEVIN	A
TUMBAGA	RINALIE	C
GALVAN	REXELE	JEAN	E
BALANDRA	RENE	JR	P
RAMOS	MARIA	JELLAINE	H
HERRADURA	ALDRIN	G
DEL.ROSARIO	APRIL	NOAH	F
SALAMATIN	CATHERINE	JOYCE	B
JAVIER	KATHRINE	ANNE	L
MARTINEZ	BEVERLY	P
CORPUZ	SANDRA	B
HEMEDEZ	KATHRINA	ISABEL	M
RIVERA	JEB	F
GARRAEZ	JOY	ANGIELA	H
VICHO	PATRICIA	A
GUEVARRA	MARY	GRACE	P
DIZON	PAUL	ANGELO	B
ILMEDO	MAIKA	R
LEONCIO	AILEEN	KORINA	F
QUITADIO	KRIZELLE	ANE	C
VILLANUEVA	STEPHANIE	N
CANARE	ALLAN	A
CASIMERO	FAYE	VICTORIA	C
BATERINA	EZRA	MAE	T
RIVERA	ANDRIA	P
PEDROSA	VERONICA	RAE	G
JORDAN	JOSE	HORACIO	A
MALABANAN	KIM	ALBERT	J
CATSAO	KRISTINE	V
SEBASTIAN	MARK	PAUL	Y
CALIMBAHIN	CAEZARINA	MARIE	F
ARGUELLES	KENNETTE	E
TOLENTINO	MARION	CLIVE	A
FERRERA	JEFFERSON	R
PENALBA	MARIA	KATRINA	E
CRUZ	MARIA	MAE	L
FLOTILDES	MARY	JOY	T
CUSTODIO	CAMILLE	BERNADETTE	V
DY-LIACCO	LEANDRO	N
CORONEJO	SAPPHIRE	T	P
STA	MARIA	YURI	P
BARTE	BEA	NADINE	V
DE.VEGA	KATHLEEN	KAYE	DC
LAQUINDANUM	SHIELA	J
AGUAS	NALLA	MARIE	A
CARANTO	ANN	CYNDEL	A
FADEROGAO	FRANCIS	JOHN	F
REAMON	DIVINA	ROGELI	H
ROBERTO	ROWENAH	MARIE	R
BOLIGAO	RONELLY	RAE	D
REYES	RICHARD	E
SHIMODE	ALYSSA	MARIE	D
CAGURONG	LEO	LLOYD	DL
RIVERA	NATALIE	JOYCE	H
AGMATA	ALTAIR	B
MAGTOTO	CLARENCE	Y
BARBOSA	JUSTYNE	F
DINAPO	MARI	A
ROXAS	CELINE	BERNICE	A
LIBAO	JOHN	DELF	M
TIANGCO	LALAINE	DIXIE	L
RODRIGUEZ	DANICA	A
CRUZ	PAUL	DAVID	C
VICTORIA	ROBIE	JAY	A
PADILLA	JEANNINE	T
AVILA	RIO	MARIZ	A
MERCADO	JESSAMINE	JOY	B
ROLDAN	RONALD	JR	R
CALINOG	ALLANA	B
TEJADA	JOSEPHINE	GRACE	M
DANAS	JENNIEZENT	S
MAGCALAS	MICHAEL	ROSH	A
LEDESMA	JAIME	RAFAEL	A
NORONA	ANDREA	C
SITJAR	ROI	DS
MANUZON	AUGUSTUS	D
PASCUA	MC	MELVIN	B
CAPULE	NATHANIEL	M
SACLAO	CHRISTIAN	DC
CORPUZ	PATRICIA	GRACE	S
MERCADO	MARIVIC	T
ROGADO	RELI	FAYE	L
AGUILAR	HANNA	FREGINE	D
CARLOS	MARIA	ELENA	B
DE.CASTRO	MARIA	MONICA	T
BUCKS	BRANDO	BERNARD	C
KARUNUNGAN	RENEE	JULIENE	M
ORTEGA	KAREL	JOANNA	M
DALAO	ANGELA	KRISTEL	A
JAEN	EUNICE	MARIE	A
CARITATIVO	RASHEEDE	FAYE	R
ATIENZA	TEDD	FRANCIS	DC
YANEZA	SAMANTHA	KIM	D
MENDOZA	JAYDEE	P
CANUBAS	HANNAH	CHERYL	G
BISMONTE	KAREN	A
LLANTO	LEMUEL	M
GALBO	MARY	CLAIRE	M
SUICON	APRIL	ROSE	C
LALO	MYKA	GUINEVERE	B
VALERA	KAYE	RAE	T
CRUZ	GERMAINE	S
ENCINARES	JOHN	MARK	A
NOGOT	JAAN	CONRAD	P
CALIMAG	FLORIBEL	C
LORESCO	ELEASAH	F
NAQUILA	RHEA	KATRINA	P
ABANGAN	JOHARA	F
MANANSALA	ANGELIE	O
MENDOZA	JARED	JORIM	O
BERSOLA	MARY	ANGELIE	I
QUELIZA	JOHN	CHESTER	P
BROCE	GLADYS	P
OCHOA	NOEL	M
GRAJO	GLORY	GRACE	P
BANDAO	MAUREEN	GAY	A
FLORES	NIKKA	BIANCA	S
IGNACIO	CLARISSE	ANNE	T
CARAG	HAROLD	M
BRAGA	AUDIE	B
BATANG	DORRIES	B
OLAGUERA	LYNDON	MARK	P
VIERNES	LORD	BRYAN	G
TABUG	KATHERINE	T
ALLAM	ELIZABETH	G
JARAMILLO	MARK	GIL	T
ESPERANZA	MA.CARLA	R
BAINGAN	MARVELYN	P
GARRINO	ABIGAIL	L
ESPIRITU	DARYL	JOSHUA	SJ
CRUZ	MARIA	FE	R
ONOFRE	SIENNA	LYSTRA	L
DE.JESUS	JEROME	N
AUSTRIA	LIAN	ROBERTO	L
ICASAS	ERIC	RYAN	M
TABLIGAN	DENISSE	SOLEIL
CARANDANG	MARICHELLE	D
VILLAMOR	KEVIN	G
DIZON	JOHN	JOSEPH	R
DIMAANO	FRANCIS	JOSEPH	R
NIEVA	MARY	SYRAHLYNN	C
GALUPO	DORCELLE	GRACE	B
GARCIA	ANGELA	NADINE	C
FELIX	ABIGAIL	N
ORTEGA	JOHN	ALBERT	C
FONTANILLA	JOSE	GABRIEL	S
SIBORBORO	CHRISTINE	B
VENDIOLA	BETHUEL	REIN	M
TULIO	FAYE	MARIELLE	B
MARASIGAN	PAULO	EMMANUEL
BALAALDIA	GRAZIELLA	JOY	C
DELICA	APRILLE	JOY	A
MERILLES	MA.LOURDES	D
IBANEZ	ALEJANDRO	S
BATTAD	PAULYN	MARIE	M
BULAN	JOSEPH	NINO	M
CANO	GLENN	ALEXANDER	J
ANSAY	EATHERLY	CIARA	A
CUENCA	MIGUEL	PAULO	O
MARASIGAN	DENNIS	ANGELO	R
POBEDA	FATIMA	MARIE	D
SIMBOLAS	LEA	P
FERNANDO	RAFAEL	CARLO	B
SAN.JUAN	CHRIZARAH	A
AMPONIN	MICHAEL	JOHN	G
AMBITA	ISRAEL	DAVE	V
ESPIRITU	LEANDRO	O
MENDOZA	HERVIN	ERROL	T
BRIONES	RUTH	C
PELAYO	KATRINA	REEZA	G
ULANDAY	JOHN	LAWRENCE	S
MARILAO	MARY	ANGELINE	A
JASARENO	ROXAN	A
DIOLA	IVY	ZANDRA	B
GATUS	EDMAR	N
PABUAYON	ISAIAH	CATALINO	M
REYES	FLORELLI	MAE	Y
ALEJO	JAIMIELYN	W
ENRIQUEZ	JUAN	CARLO	C
ADAJAR	JOAN	CHRISTINE	O
HERRELLA	DANIEL	T
SANTAYANA	MABEL	N
EMPENO	MARIA	KRISTEL	A
ARANA	RACHELYN	ANN	S
VELANTE	ROSE	DAYLE	S
BAROJA	MICHAEL	III	DG
MACASAET	JOSEPH	PAOLO	A
GONZALES	KATHERINE	M
JIAO	BENJAMIN	JOSEPH	D
MEDINA	KRISTINE	GRACE	P
DE.GUZMAN	JOAN	RICHEL	P
CASTANEDA	LADY	FRANCES	R
BARTOLOME	OSCAR	JOHN	A
VILA	JEROME	R
BEANO	DIANA	PAULA	S
ROBLEDO	SARAH	ANN	I
PRODIGALIDAD	DENELYN	F
DEL.ROSARIO	APRIL	ROSE	O
ABADICIO	EUNICE	R
ARIVE	KEITH	ANN	M
HINTAY	JERIAH	R
IBAL	JERALD	CONRAD	P
PEREZ	JESSA	G
DE.CASTILLO	JESSEPH	EDRIAN	D
PERALTA	PATRICK	BRYAN	B
GOMEZ	THRIXIA	ANNE	P
FAMA	ABIGAIL	DC
CENTENO	QUE	ANN	Y
BERDOS	MYRRICAR	LOREN	G
CONCEPCION	ADELISA	A
LAPENA	KARLA	THERESE	L
ALBIAD	MARICRIS	B
CASTILLO	KATHRINA	D
TARRE	JEZREEL	B
BAUTISTA	KEVIN	MOSES	E
CHUA	MARIA	ANNAH	C
GLIBAN	JANINE	GUY	G
SINGH	JULIET	O
ARANDIA	PRECIOUS	MARIE	D
PEREZ	MARK	ANDREW	E
ALEJO	DIANNE	VANESSA	M
RONDARIO	JEANNE	PAOLA	J
BELARMINO	BRENT
AGUILAR	JOHN	MICHAEL	N
ZARRAGA	ALFRED	R
ZORILLA	PRINCESS	MUTYA	R
ALMEDA	ELLEIN	STEPHANIE	C
CASTRO	ANGELO	C
BUNDALIAN	MARIAN	C
CATANGHAL	RONAN	ALDOUS	M
PARDO	MARIA	JOY	B
TUBIERON	DOVIE	SETH	R
EVORA	REXLYN	ANNE	M
AGBAYANI	GIRLIE	ANN	R
FALCULAN	MAILAN	YANCY	T
MACAPANAS	MANSUETO	JR	S
TAN	KATHRINE	ALYSSA	T
RAMILO	JEAN	LOUISE	A
BANADOS	SHIELA	MAE	A
AGUILAR	JUAN	MIKHAEL	G
BIAY	MARC	ANTHONY	M
ONA	IRIS	STEPHANIE	P
AMORES	JANINA	MAY	C
DE.ROBLES	MARIE	BETEL	B
NARDO	EMERHIN	JOY	V
COMIA	JULIE	ANN	R
TENDERO	KAROLINA	SOL	T
MOZO	HAZEL	ANNE	A
PACO	JOHN	BERNARD	B
HAYAGAN	MARY	JOY	G
CARDENAS	JOCELYN	B
BAGAMASBAD	J-NEIL	H
COLLADA	NEIL	ANTHONY	L
NACARIO	MAE	ASHLEY	G
RIVERO	CHRIS	ANGELO	O
SERRANO	KARLO	JOSE	V
PURIFICACION	DANAH	MARIE	P
PEREZ	REONEL	V
RABE	CARLO	CRIVELLI	H
REDILLAS	KIM	BERNIE	L
LAGANTE	ALEXIS	MARION	A
VALDEZ	ROSELLE	MARJORIE	P
BAGUIO	KRISTINE	JOY	C
DELOS.ANGELES	MARJORIE	D
LOPEZ	JAY	EDSON	S
ARIGO	MA.CAMILLE	M
BULADACO	MARCIAL	II	S
SENTILLAS	KENNETH	ROY	E
BACUD	RAQUEL	JR	P
GUIYAB	JAMILLA	A
ESQUIVEL	DAN	OLIVER	V
TAMBAOAN	REBYSARAH	S
SALANGAD	OLIVER	B
OLA	JARVIL	VINSON	R
LAGARE	JACK	ELENDIL	B
BOSAING	AMY	APRIL	D
LORENZO	PAULINE	JOY	M
ROMASANTA	MYRA	R
AGUINALDO	GEMA	SHARMAINE	S
MAXIMO	KRISMAGNE	M
CENTENO	ELOFFER	JEHSON	E
PAGES	JAN	CHRISTIAN	A
DIZON	ZARA	JANE	N
MARANAN	KRYZL	L
PAMPLONA	ANGELI	C
TOLENTINO	REINA	T
DE.CHAVEZ	GERCIA	R	D
DE.GUZMAN	LAURA	LI	F
JIMENEZ	FRANZ	ALAIN	M
ALBURO	DOMINIC	JOHN	C
MAYORES	RORELIE	B
CARINO	GRACE	ANGELIQUE	F
SALABI	SITTI	KHADIJA	U
LACTUAN	LEI	KRISTOFFER	R
OLIVA	ANGELA	J
SELISANA	SHIELA	MARIE	G
GONZALES	AIRISH	B
DEJUMO	JINKEE	T
CLARITO	QUENNIE	M
ONG	JOHN	DANIEL	P
FACTOR	CATRINE	JELL	B
PIANO	MILKAH	M
PANDI	JONATHAN	RAYMUND	M
JUSTO	APRILYN	JOY	DC
BIEN	VICTOR	E
BULANHAGUI	NERISSA	B
TANA	OSMOND	MORRIS	E
DIAZ	BELLA	STEPHANIE	E
LOTA	RODESSA	MAE	G
CRUZ	JOREL	EVAN	S
LUMENARIO	MARY	GRACE	R
ENCINAS	JOHN	EMMANUEL	I
FAMILARA	MAEAN	CRYSTLE	T
COMO	EMMA	CONSUELO	O
DUMDUM	JONAS	MARIE	A
HUET	HELLEN	E
INOCENCIO	CRISTY	S
MAGTIBAY	JEFFREY	D
AMARGO	KRISTIAN	KESTER	V
CERVANTES	JOYCE	JULIET	M
TUAZON	NINA	CHRISTINE	C
AGNA	MA.BERNADETTE	O
UCLARAY	CRISTINA	C
FLORES	ARGEM	GERALD	R
DELA.PENA	ERNESTO	JR	F
DICHOSO	MONIQUE	ROSE	R
RAQUEL	ANGEL	MANICA	V
AQUINO	REIANN	N
QUIMBO	ERICKA	JAN	DJ
MANGLAL-LAN	LYKA	T
BATIN	CYNTHIA	JEAN	G
OCA	GILBERT	M
PANTOJA	MARISTELLE	B
GONZALES	CRYSTAL	B
VILLA	MERIE	ANGELIQUE	L
LOMIBAO	TIMOTHY	JOHN	Y
HIPOLITO	EA	MARIE	P
ARTUZ	EMMANUEL	B
DE.MESA	MARK	DOMINIC	M
GRAMATA	BRYAN	JAY	A
MARCELINO	ROCKY	T
CAGUIAT	ANASTHASHA	F	D
MEDINA	HANNAH	MEI	R
POMER	RACHEL	JOANNE	B
ALIGUI	ALEC	ALISSA	F
BUENDIA	IDOHNA	LEAH	J
CARINO	ALNEE	JOY	M
PARDUCHO	VINA	ANGELICA	A
RAYOS	ANTONIO	JR	L
RUBIO	JO	PATRICIA	R
ELEC	CELINE	S
ESTRELLA	JOSHUA	ANGELO	N
ELAYDA	MICAH	TERESA	C
CARAIG	XANEA	KRYZEN	M
LOPEZ	ALLANA	PAULEEN	L
BISA	JUDEL	Z
TOSINO	MONICA	DM
ARABEJO	LIAN	MARIE	R
VELANDRES	HANELYN	C
RIVERA	MARIE	ANGELIQUE	C
TAGUILASO	MARICEL	V
FAJUTAG	APRYL	JOY	M
FLORES	BERNARD	FRANCIS	C
SANTOS	RAY	EMMANUEL	R
CASCO	JANEAL	CHARMAIGNE	N
DELA.CRUZ	ALFRED	G
IBAY	JOHN	PAUL	M
FALAME	CHRISTY	JOY	DL
DELA.VINA	ANGELO	B
BALLESFIN	MA.LARUE	E
DELA.CRUZ	KATHERINE	R
LOPEZ	MICHAEL	A
PANGILINAN	SHIMEI	R
RAMIREZ	EZEKIEL	GUY	M
SARMIENTO	PERCIVAL	S	M
SALES	PATRISHA	LOUISSE	O
CARANDANG	SAM	DANIEL	Q
LAPITAN	JONA	YOANA	C
ALLER	II	GILBERTO	G
ANI	MAILA	CAMILLE	B
AQUINO	ANN	KAREL	A
AUSTRIA	ROVEL	EMMAN	G
BORDEOS	PATRICK	ALEXIS	A
CUTAY	SANDRA	JELYN	G
JAVIER	PAULA	EUNICE	R
MADRID	IVY	JANE	W
SALAC	VITTORIO	LLOYD	G
SERRANO	NYKA	SOFIA	C
SIOSON	BORIS	G
TOLENTINO	MARK	ANDREW	D
DOMINADO	JULIUS	LOREN	B
KATIMBANG	RACHEL	D
BAUTISTA	JIZZA	MARIZ	U
SANCHEZ	GEISHA	LYN	B
ESTURAS	CLAIRE	RUZZEL	A
SOLIVAS	JOCELYN	C	T
MAALIW	APRIL	JOY	B
BINASOY	MITCHEL	KATHLYN	G
ARIZABAL	CHAZEL	MAE	E
BORROMEO	MAURICE	C
GARCIA	MARVIC	PRINCESS	R
DELICANO	REGINE	ABBY	B
BAUTISTA	JOHN	EDERICK	V
BERNARDINO	RODELIO	JR	DG
IBASCO	KERVIN	DR
CANDA	RYNA	STEPHANIE	M
CUE	JOHN	MICHAEL	O
DE.GUZMAN	FERIZALYN	G
SENJU	TOMOHISA
CELLE	DEITY	A	JR
TORRES	PRINCE	GERALD	M
BUENO	MARLET	C
HANDA	DONNA	MARI	P
GALLITO	XYRUS	RAFAEL	C
HER	SAEROK	LEE
CORTEZ	MIA	ANGELINE	V
FRASCO	KRISTINA	MARIE	F
JUNIO	LORAMINA	B
FAJARDO	MARIA	ANA	D
LIBERATO	KRISHA	MAY	M
VIENES	JEVALYNE	S
JOSE	MARK	JOSEPH	N
BAUTISTA	KRISTINE	ELAINE	P
ILAGAN	ROSE	ANN	A
PARCASIO	MA.ELIZABETH	T
LUCES	KATHERINE	T
ADAO	JED	DOMINIC	V
TOBIAS	CATRINA	JIREH	A
MENDOZA	MARVI	M
PICCIO	JOHN	ISAAC	T
VELASCO	RACHEL	ANNE	C
INGUENGAN	ANA	KATRINA	M
CABAL	MA.KATHLEEN	C
TAN	MARIEL	LOUISE	O
DEL.ROSARIO	ALETHEIA	GRACE	D
ANTONIO	GIEANE	MAE	F
MORALEJA	KAYLA	ABEGAIL
GOMEZ	MA.ANA	A
LAJARA	CZARINA	MAE	S
ALMOSARA	JANELLE	R
MILANA	CAMILLE	MIA	L
MELENDRES	RACHELLE	LEAH	H
SUPAN	PAULEEN	AZAZEHL	B
CLEMENTE	JEMUEL	P
ROQUE	JUAN	RAFAEL	L
SUNDIANG	PATRICIA	MAE	G
AMBERONG	MICIAH	GRIS	T
MARIN	JONELLE	E
HIZON	REMIL	DJ
OLAP	WILBERT	A
CUENO	ROUVEL	P
DIONISIO	CHRISTIAN	DJ
BANATICLA	MONIQUE	G
PADILLA	QUEENIE	V
VILLATE	JANINE	DG
VELASQUEZ	KIMBERLY	MAE	P
ABELLA	PAULA	BIANCA	S
LAVARRO	JAENA	LAURELLI	S
ORILLA	CARLA	PATRICIA	G
CABABASAY	LOVELY	KRIS	R
CARILLANES	MARIE	ARENBI	I
FURIO	MA.CARMEN	F
SALAVERIA	LORRAINE	ANNE	F
SUICO	THEA	CECILIA	F
MANAGUELOD	IVY	MARIE	B
CASTRO	ALYSSA	BETTE	DC
MENDOZA	MARK	ALVIN	L
PERONO	RACHEL	MAE	G
DINAPO	JESSA	A
CONSTANTINO	JOAN	MIRABELLE	Q
DE.LEON	JANINE	MARIEL	G
ORIA	JON	FRANCIS	M
VIOLETA	JOY	DENISSE	V
MANALAC	MIZIEL	D
MANALO	MARICAR	ESTHER	O
MENDOZA	KIM	SONY	L
MAGSINO	MA.ANDREA	C
GALAPON	MEEHRIS	F
RAMIREZ	LANCE	KRISTOFER	N
SOLIS	DYAN	ELIZABETH	J
BRION	MYKA	SHEM	S
DUQUE	KEVIN	GLEN	P
FANDIALAN	VENIECE	AINSLEY	A
CRUZ	KRISTALLE	G
CABANGBANG	MA.ANGELICA	P
GAPAC	GILBERT	LUIS	F
JACINTO	JEROME	C
DALAGAN	JULIA	I
IGCASAN	LARA	ANGELIQUE	S
LORENZO	JOHN	CHRISTOPHER	A
CARAAN	MARISSA	FAYE	P
CASAMA	IMARI	FAYE	G
HERNANDEZ	PAULINE	MARIE	V
MASUNGSONG	DENISE	MICHIKO	M
ROGELIO	ROSETTE	ANNE	O
MAME	RENE	M
PENA	JUAN	CARLO	M
ASI	RANELLE	JANINE	L
MENDOZA	JAEL	MAUREEN	M
AGUINALDO	KORINTO	MIGUEL	G
ARCEBUCHE	JOSEPH	NEIL	M
MARASIGAN	JOHN	CARLO	M
LAURIO	MARK	LOUIE	D
BALAHADIA	CHRISTIAN	PAOLO	B
LAMAR	NEIL	PATRICK	G
BRITO	MARY	JOYCE	O
MAEZONO	SAKURA	ERI	B
CASTANEDA	BIANCA	NADINE	V
ALVERO	LOURDES	JAN	R
HERNANDEZ	JOSEPH	ELMON	C
BAYLON	LYZA	BERNADETTE	A
CONSEBIDO	PRINCE	PAOLO	G
BURCE	VINCENT	M
REYES	MARIA	AMIELLA	E
ANTONG	ANNIERAJ	G
BALANAY	KERVIN	A
GUAN	DINO	PAOLO	L
CADAG	BERNADETTE	B
ARROYO	BEVERLY	R
LIM	MARIA	LUISA	C
ANDRADA	LESTER	AVAN	G
SOLIGUIN	JENIKKA	U
MATRES	JERLIE	MHAY	K
EVANGELISTA	SHYRLYN	LORENZ	M
PEREZ	KINSLEY	MEG	G
ANOSO	PRECIOUS	SARAH	A
ENCINA	MA.ABIGAIL	G
BORDEOS	LAWRENCE	FELIX	A
DE.JESUS	MARIA	JASIEL	G
PALMA	CEDRIC	B
ENDIQUE	JOANNE	WINLY	L
ALCANTARA	ABEGAIL	N
CORNEJO	CHARLES	ANTHONY	P
SOLACITO	RIENA	MARIE	L
CRUCILLO	MARIA	DOMINIQUE	S
CARABUENA	JUAN	PAULO	A
DATINGUINOO	SHEENA	C
AGCAOILI	MARIA	NISSA	P
BONIFACIO	JUSTINE	B
SILAPAN	MIKAELA	NADINNE	A
BENITO	ELIZABETH	L
TUJAN	MA.ANGELICA	A
VILLANUEVA	JERIC	C
LEYSA	MARIELLE	A
CUERDO	MARICRIS	S
ARCE	AYA	M
DEOMAMPO	CAMILLE	ANGELICA	M
DIAZ	MANUELLE	MARIE	C
ALPECHE	ZYRELL	JOY	S
PUJALTE	MIRASOL	V
CABIGTING	SHENLENE	A
LAGAYA	JAQUILYN	R
YAP	JANINE	D
DALDE	MELODY	A
MENORCA	ANGELA	KRISTEN	R
MALAHITO	MICHAEL	C
KAHULUGAN	JOHN	IRVIN	D
MERCADO	DEXTER	C
DONATO	MARICAR	M
CRISTE	CRISSELLE	C
ALDEMITA	GLORIA	ESTER	A
DEL.ROSARIO	JERICO	C
FUNTANILLA	BASIL	Z
CO	NADINE	P
LO	ROME	JOYCE	R
GUERRA	IVAN	KING	A
BAUTISTA	JOANA	ELAINE	F
DE.MALIGAYA	JENIFFER	DP
MANGUBAT	ANGELIQUE	A
JIMENEZ	ERICA	LEANOR	P
ENRIQUEZ	ROSELLE	MAY	S
MAGPANTAY	GRACETINE	D
PLETO	JOHN	VINCENT	R
TY	KRYSTIAN	KASHE	S
PACIA	JOHN	CARLO	F
DEL.ROSARIO	TIMOTHY	JOHN	D
LABRADOR	DEZIREE	A
CARANDANG	ANA	D
NAVAL	JOSIE	ISABEL	CAO
VERANO	RONALYN	R
NACORDA	CHRISTIAN	ANGELO	P
DE.LEON	REN	ANTOINE	D
MANZANO	BARON	GERARLD	SD
LAURENTE	JETHRO	C
VELASCO	MA.CZARINA	G
OTSUKA	YUICHI	T
BRAVO	RONA	KARMELA	D
MENDOZA	CHRISTIENNE	CHARIZ	B
HALILI	JOHN	PATRICK	M
SORIANO	ESTHER	ANN	B
LAXINA	NATHANIEL	S
NUNEZ	RUTH	C
SUSI	KIM	JANINE	R
CACHUELA	ANNA	ROSENEL	S
NOVAL	MARGERRY	ANN	S
VERGEL	JOHN	ERICK	B
OROSCO	FREDMOORE	L
ANONUEVO	OMAR	R
LAYOG	CECILLE	M
BATOCTOY	DESSA	CAMILLE	R
BANTA	TEESHA	CATHERINE	R
CALAYAG	MAUREEN	PATRICIA	A
PASION	DARYL	Q
URGELLES	RICHARD	G
FODULLA	ARIES	F
BARTOLOME	JHON	KRIS	F
ROQUE	VAL	MARTIN	D
SAMANIEGO	KIM	P
FERRANCULLO	LIZA	ROSS	F
AGUIRRE	MARY	ANGELIE	G
MANUBEN	JOHN	JULIUS	P
HONRADE	LAMBERT	B
SMITH	JUSTINE	MAY	M
JASARENO	CATHLYN	A
ANGELES	MICHAEL	M
BRECENIO	IRISH	N
CALAWAGAN	CARAH	LYN	G
TANALA	MEG	LORINZE	J
ENOVAL	KARLA	PATRICIA	A
GASPAR	MARIZEN	B
VICTORIA	ARMIL	JAYNE	C
MENDOZA	CYRENE	AMOR	B
BONGA	SARAH	BERNADETTE	B
BAYLOSIS	NOEL	FRANZ	J
ODIGIE	INEN	ELIZELE	D
BALBIN	KENNI	MARIE	R
ISIDRO	JOANA	MARIE	C
MANZANO	DIANE	A
SILAO	ADONNA	L
FORTALEZA	JOCELYN	P
SAAVEDRA	GERALD	N
MACASAET	LUISSE	MARGARETTE	A
REYES	JASMIN	M
VILLACERAN	PATRICIA	MARIE	B
GAZMEN	KRISTINE	ANN	G
PASION	NEA	JEM	F
FAJARDO	FAITH	CAMILLE	A
ANGELES	MARVIN	JOHN	P
AGUADO	ELIZABETH	M
AGUILA	IVY	JOY	U
TRIA	GEVONS	JOVEN	T
ALCAIDE	ARIANNE	R
VILLAREAL	ALSON	JED	J
DE.GUZMAN	CLARENCE	JOY	C
ERMINO	ANGELICA	P
RAZ	GIELEN	C
DE.GUZMAN	GYRA	MAY	M
BALAYAN	MARIA	NAOMI	C
KABIRI	AZRA	MAY	B
DELA.CRUZ	CERISSE	ANNE	B
MOJICA	EDEN	ROSE	DS
SALGADO	DAVID	KERVIN	R
PANGANIBAN	RACHEL	MAE	O
BABAAN	MARBIE	DANICA	D
AKIM	JANEL	EVAN	P
MAGPOC	LAWRENCE	C
DE.LEON	CIREZ	LOREN	A
DAILO	LALAINE	L
FORNOLES	CYRUS	ARIEL	DR
STO	TOMAS	MARIA	KAREN	P
SINGSON	PAUL	HENRY	V
VERDEJO	JANINE	A
CONVITE	SHERIDAN	MONIQUE	DS
SINO	MARIA	FRANCHEZKA	L
OLAZO	JOMER	E
ESPERANZATE	JOYCE	ANNE	DA
ABLAZA	JESSA	LORENA	B
ADOLFO	ELAINE	FRANCESCA	M
LAUGO	KIMBERLY	G
PLARAS	JAMES	CARLO	E
FAMA	JEN	BEA	DC
TOLENTINO	KAREN	ANNE	S
BARRETTO	LADY	TONI	A
DELA.ROSA	ZYR	U
PAWIG	JEMINA	MICAH	J
GONOCRUZ	RUTH	ANNE	T
SANCHEZ	MAVERICK	S
PAGCALIWAGAN	JOSEPH	L
VELECINA	VERA	B
PEREY	RACHEL	G
VALDEZ	XANDER	MAURICE	Q
SINAD	KORINA	VIDA	G
MABITA	JAEDIE	RUTH	D
JOSUE	ELRON	JOYCE	M
SORIANO	EMMANUEL	C
MEDINA	AIRA	CAMILLE	M
PEREZ	RUTH	A
CANLAS	MERRYL	R
DE.JESUS	CYRILLE	COLLENE	P
MABALOT	LEI	LANIE	C
VILLAMOR	MA.KATRINA	A
VERDADERO	CHRISTINE	VICTORIA	P
MARASIGAN	JANELLE
BATION	CARLO	LUIS	M
VANO	BRIAN	T
TONEL	ADRIAN	VINCENT	A
MACARAEG	KEVIN	C
PALAJE	ROSE	MARIE	M
DIZON	RYAN	NICHOLAI	L
YAMBAO	RAINIE	CHUCKY	S
SOTTO	MARNELLI	P
LOPEZ	MARIA	GELYN	G
PILAPIL	AIMEE	LYNNE	A
DELLUBA	PRINCESS	JAMIE	P
JAVIER	MARY	JOY	V
JAPSON	MARJORIE	B
DELGADO	KRISCELLE	D
FERRER	MA.ELOISA	I
REPOTENTE	CATHLEEN	N
LEDESMA	EARL	JAY	F
CAGALAWAN	AIMEE	G
MANZANO	GEMINNE	G
SOLUTA	HAYAHAY	G
MENDOZA	IRINE	GLIZEL	L
CAMUA	LINKY	GRACE	J
MONTENEGRO	SAI	HEINZ	A
MIJARES	JUAN	CARLOS	C
DIVINO	MARION	JOYCE	R
FELICIO	FRANCISCO	MIGUEL	B
CUENTO	LEONARD	V
LOQUINARIO	GEROLD	A
ESMEDILLA	HAZEL	F
MAGBUHOS	SARAH	B
TEODOCIO	BILLY	JAY	V
CUBA	HAZEL	FAYE	S
YLAGAN	ROENT	LLOYD	M
GENEROSO	PRINCESS	JANE	R
BRAGAIS	LUIS	JULIUS	G
CHIONG	ERICA	MAE	D
PASCUA	KRINZEL	MAE	V
YABUT	JASMIN	JANE	M
BANIAGA	JESSICA	S
GARCIA	MARVIC	SHARMANE	R
ASPI	MAUREEN	R
BUHIA	PRESCILLA	ISOBELLE	B
BERTULFO	MA.CARLA	T
BUTALID	RICH	S
KIPTE	MARY	JOYCE	S
PANGANIBAN	NARCISO	III	D
EVANGELISTA	VON	CARLO	DG
RABUSA	EDDILYN	F
ISRAEL	MARICON	M
USON	RACHELL	ANN	A
ALVAREZ	JAMES	DV
FRILLES	SHAYEE	B
DINA	MARIA	KRISTINA	F
FELIX	PETER	ALEXANDER	G
BANIQUED	RUSSEL	D
ABARRA	MAJA	SIERHINE	J
OCHOA	FARRAH	MAE	C
CARONAN	JASMIN
GONZALVO	JANINE	L
RIMAN	MARC	JOSEF	D
LAGASCA	MEL	RIANNE	G
FERIA	BRENT	JOSEFF	C
PASAG	CHARMAINE	THERESE	M
VAIL	SOFIA	JANELLI	DG
VIRTUSIO	JOHN	SYLVESTER	C
PINEDA	KAREN	FAE	B
ANGELES	KATHLEEN	SIENA	A
CONSTANTINO	LUVIELINE	AERIEL	O
BONSOL	DANIELE	ANGELA	B
PANER	MANUELITA	O
ENDOZO	ALLYSTER	A
MARGALLO	ANA	VICTORIA	C
FOLLERO	FATIMA	E
DELBO	JARAH	DINELLE	C
GONZALES	MARIANNA	JIN	B
JOCSON	AIMEE	M
ADUL	RAHMAN	AWAD	C
MAGPANTAY	RUTH	BERRY	O
SANTOS	RANIER	C
PAGUIO	CRISILYN	R
RAMOS	DARRIL	LOUIE	C
SUMIRAN	SHARMAINE	PHOEBE	B
MERCURIO	LENNA	RIZSA	C
LLAVE	ABRAHAM	DARIUS	S
PULUTAN	NIKKO	ROSS	C
CASTILLO	DONNA	LYN	M
TOLENTINO	MA.KATRINA	G
GARCIA	JEHAZIEL	JEIEL	A
PANGILINAN	JUNEL	A
GONZALES	JERVIS	L
BUENO	ESTHER	ANNE	F
CALIBO	JAN	CHRISTY	M
CASANTUSAN	ANNA	THERESA	R
ELEGADO	ALJON	KOJI	P
MANZANERO	JANINA	ANNE	S
MEJIA	WENDILYN	B
PEREZ	ANA	PATRISHA	D
TORRES	KRIS	ANGELI	R
MANGERON	JOMMELL	P
CARITOS	KRYSTALLE	CAMIELLE	DR
BANTOC	NEIL	ARMAND	B
BONTO	MAXIMILLAN	JOSHUA	L
CALDO	KLAUDINE	ANN	P
DEL.MUNDO	APRIL	LORRAINE	C
LITAN	JENNIE	C
SUMALDE	ANGELO	AUGUSTO	M
ALBACEA	JOHN	PATRICK	VJ
BUENCONSEJO	ROMELYN	O
CARANDANG	MONINA	CHARINA	B
DELA.CRUZ	ALYSSA	CAMILLE	P
LO	CHRISTIAN	JOHN	M
MONGAYA	JAKE	ROBERT	M
QUIMBO	PATRICIA	ANNE	T
TAMAYAO	PAUL	JEMUEL	S
CEASE	CINDY	C
CUEVAS	MARC	ALEN	C
ABOGADO	ROWELL	P
PARDO	KRISTYL	CKAYE	E
MALITIC	GERALDINE	ANN	V
SIMBAHAN	JONATHAN	F
MIRAS	BRENTH	ANDREW	J
BRUCAL	PAULINE	JOY	A
PADILLA	FRANSHIERL	JOY	M
SALVATIERRA	BENJO	S
DELA.TORRE	LANVIN	DANNA	G
PAMILAR	JUDY	ANN	J
CHUAQUICO	JAN	MICHAEL	S
DACUTAN	DIOCEL	M
LOGO	JOVEN	VICTOR	DL
ASETRE	MARIA	ERAISSA	P
CAJUMBAN	DARIA	MAY	P
DE.RAMOS	REMELYN	I
CAPUNPON	RAMON	LEONARDO	C
HERRAS	JULIEN	PAUL	C
SOTALBO	KIM	MICHAEL	C
GOMEZ	MARIE	LOIS	M
GUERRERO	ENA	KAMILA	V
QUIZON	MIZPAH	JOY	G
PANISALES	KIT	EMMANUEL	B
MERCADO	VERONICA	M
SANTILLAN	ANTONIO	LORENZO	T
TORRES	EJAY	SJ
VALENCIA	ALBERT	AUBREY	O
POZON	ALORA	PAMELA	M
MENDOZA	DIANE	GEMME	B
DIMACULANGAN	LLOYD	BRANDON	P
GONZALES	MARIA	AIRA	D
RAMOS	MA.CRISTEL	G
DIONES	JOSE	AMIR	A
TANPOCO	PHILIP	JR	R
GARCIA	JOSEPHINE	MARIE	D
BUSENOS	ARIANNE	P
VILLA	MARIA	KATHERINE	N
BARRO	JANELLE	CRISTINE	M
ALBIS	MELANI	T
BERGADO	RHEALYN	PRINCESS	A
LEE	JASTINE	ANABEL	V
ANTARAN	ABBIE	B
ABARQUEZ	CHARMIE	I
CABANBAN	KASSANDRA	GEM	DV
PONTEVEDRA	BERNA	CORINNE	O
TABANGIN	JASTINE	MARIE	DL
SORIANO	MHERMAEL	ANGELICA	P
LUCAS	TRISTAN	JAN	C
ANTONIO	BETHANY	JOI	L
RODULFO	RITCHE	A
TUBALE	ALFRED	C
OBIAS	PATRIZIA	S
OBIAS	JONAN	MARIE	F
MAGALONA	GILY	V
TORRAZO	ZARAH	MAE	T
TRIA	BRIAN	G
DEL.AGUA	NATHALIE	T
RAFER	PRECIOUS	MAE	R
IBASCO	SARAH	JANE	A
CANO	JESSA	B
VALDEPENAS	RACHELLE	M
LIBAN	YELLOH	RHAIZA	B
GAURAN	MELISSA	ROCHELLE	M
CUANANG	VINA	ERIKA	O
DAMO	JEAN	LOUISE	C
ESPENOCILLA	RAF-ANDREW	B
LOLOS	ERIKA	VENN	E
MASONG	DARLENE	JOY	C
ISIP	ROQUE	JR	M
BANTIGUE	MARY	CHRISTINE	J
MABBORANG	HAZEL	ANNE	D
SULAPAS	JOLLY	JOYCE	S
FAURILLO	FATIMA	DC
BALTAZAR	SARRAH	GIANELLE	C
LACSAO	JEELA	FLORENCE	A
DEL.ROSARIO	ALYZA	MARIE	D
SAN.LORENZO	HIROSHI	C
SIMPAN	APPLE	MAE	G
ALCANTARA	NATHANIEL	R
MASINLOC	MA.CATHERINE	G
BINALAY	CAROL	P
RAMOS	RALPH	VERNOULLI	A
AMBOY	ANGELITO	G
ZAPATA	IRISSE	M
PRADO	MAXINE	STEPHANIE	M
MANIGO	JERA	ALVINA	M
CALIS	GINETH	GRACE	C
TAMPOCO	JOANE	C
BITAO	PHILIP	E
LLONA	LEONALYN	C
DIGNOMO	JOENAH	B
TAGAPAN	MARICAR	S
MINGUEZ	KRIZ	JOI	L
GALLENITO	MARC	VICTOR	F
GARRA	MARY	ROSE	B
GUTAY	SUYEN	T
JAZARENO	JINKIE	S
TATEL	ANA	CARMELA	T
BERNALDO	JACYNTH	MARIE	F
DANO	JANELLE	STEPHANIE	D
JUANILLAS	VENICE	MARGARETTE	B
BORJA	SHIELA	KATHLEEN	L
AUSTRIA	ALDEN	G
AMARILLE	ANNA	THERESA	M
REMOROSA	VALERIE	FAY	A
GENOVATA	MA.GINELLE	G
INOCENTES	GLADYS	A
SERATO	JO	LINDSEY	G
ASIO	ANGELICA	S
BURGOS	RAMON	JESUS	P
CUMBAO	JOY	LINE	T
MAGPUSAO	JOSE	JULIANO	A
MIRANDA	KATHERINE	MARIAH	A
ROXAS	JESAN	R
EDER	BENILDA	CRISTINA	C
GALAPON	DEAN	MARTONI	R
TANDOC	PATRICE	ERIKA	M
MALIGALIG	ANDREA	FRANCESCA	C
CAMACHO	LOIS	AGATHA	G
TABUDLONG	PAUL	SJ
MAURICIO	HENRI	ROBERTO	H
SUCALDITO	PAMELA	GRACE	S
CORONEL	ALEXIS	JOYCE	M
DAWAT	KARLA	MAE	A
PILI	ALMAR	DB
TUVERA	JAMES	RENALD	A
BULADAS	IVIEJOY	L
HUELGAS	MARK	HERSON	F
ROSALES	ATHENA	JEANNE	E
BUSTOS	JOHN	GREGORY	C
DESUYO	FARRAH	MAE	G
BAYBAY	SOLIDARITY	I
MANGUIAT	PAUL	ALBERT	M
LACSAMANA	MARIA	KRISELDA	G
MORADA	JOAN	P
PERALTA	REY	KELVIN	R
PENANO	ALJHON	VINCENT	B
FAMOSO	APRIL	HACHEL	A
CAJURAO	MIKKO	G
SANCHEZ	MELISSA	MAE	R
ORDILLO	SABRINA	GRACE	P
MASIGAN	JENNICA	PAULA	C
BERNALES	ASTRUD	P
DE.LEON	RENHART	C
KATIGBAK	PAULA	MARGARETH	R
LIGAYA	JOSCHELLE	S
MORALES	KRISTINE	ANN	C
VILLAVICENCIO	JAYSON	M
BICALDO	PRISCILLA	RUTH	D
OBRERO	RICK	JASON	G
BACAYO	EDEN	L
ALMORA	JAIME	JR	D
ASILO	MARIA	BETTINA	A
BANEGA	KRYSTYN	G
LALICA	JIVER	S
BATTUNG	JONEL	T
GAMBOA	RUSSELL	MARK	A
RANA	JOAN	A
SOLIBA	BISMARCK	JR	I
ANONUEVO	ALDRIN	B
CARABLE	JOVIENNE	KEZIA	V
DIAZ	JEZHREEL	P
GALANG	DWIGHT	LESTER	Q
RADA	MARY	ANN	U
MONSANTO	JANAH	P
NAVARRA	JOHAR	S
ARELLANO	REGINA	MAE	Q
GONZALES	JON	CARLO	B
MIJARES	NATHANAEL	DG
FUENTES	ROVEN	ROMMEL	B
AMENCRUZ	NADINE	P
TANGAN	HANNAH	DIANE	C
ARUGAY	KENNETH	EDGAR	D
DE.GUZMAN	SEAN	PATRICK	C
MANGADA	MYKHAL	GIDEONI	L
CADIZ	MARA	ANGELI	E
ARANILLA	CARMELA	DO
MOCEROS	KAREN	MARIEL	Q
SERIOSO	KAYLA	MARIE	B
MENESES	XIENNIA	B
MENDOZA	CARLSON	J
DEL.RIO	JUDE	DOMINIC	T
GAVICA	ANGELA	ANN	D
SALUSTIANO	JEO	MARI	P
LLANTADA	KRIZZEL	JESSICA	E
MENDONES	MARCIELLE	MAE	J
MOVIDA	ALXIS	JOHN	C
ENDERIO	JEMARIE	B
BELARO	IVY	CAROL	C
SAMACO	MANUELA	A
LIZANO	MA.REIZA	DR
BACUD	JOHN	PETER	B
UY	SIA	BIANCA	P
HERMAN	GENE	ETHEL	P
PINLAC	BRANDON	YMMANOWEL	A
IRINGAN	REINA	MARICA	B
BORLONGAN	RUBY	CLARISS	M
LAYCO	LAURENZ	KRISTOPHER	J
MENDOZA	MA.JESTINE	J
CAGUINTUAN	JENNIFER	MICHELLE	A
BEJO	JANINE	GAIL	A
RAVANERA	ELLA	PATRICIA	T
MINA	KEVIN	JOY	P
LUMBERIO	KIMBERLY	JOY	D
EA	JUAN	PAOLO	B
CRUZ	JOSE	FRANCISCO	S
PALABASAN	RUBY	M
MENDOZA	KIMBERLY	ROSE	C
ESGUERRA	ROXANE	A
YAMBOT	JOHN	LORENZO	A
RAMIREZ	ARNA	SHARLYN	M
PEDRINA	KATHERINE	D
LUNA	CK-ROM	M
SALVADOR	EUSCEL	T
DELA.CRUZ	CAMILLE	DAWN	S
VILLAVERDE	ELEANOR	C
LOPEZ	EMIL	LORENZ	A
MANALAC	CHRISTIAN	EDUARD	P
BALBUENA	ARNIE	MAE	E
FERNANDEZ	MEURIEL	J
IGNACIO	LOTUS	C
MANALOTO	KAREN	MAE	Y
LOPEZ	SAMANTHA	M
REYES	TRICIA	S
FORTUNO	MARY	JOY	G
ELY	FLOR	L
SARMIENTA	KAREE	SHARMEE	L
BESITKA	SOPHIA	NICOHLE	P
CAGAHASTIAN	NASTASSIA	A
GALVEZ	DEXTER	ALLEN	S
CORTEZ	VANN	EPSON	R
AZURIN	PAUL	SARGEI	L
TANDOC	MARK	FROILAN	B
ALIMORONG	CINDY	P
GASPAR	MARIA	ROSARIO	L
GONZALES	JOAHNA	ERIKA	SJ
JESUITAS	CARMINA	FE	V
DE.LEON	ANA	MARIE	R
NOGOY	CELSA	ANN	P
PEREZ	CHAROSE	MARIE	T
NAMUCO	LAWRENCE	SC
GAMO	RALPH	ROEL	H
MALIT	FRITZGERDAN	S
LAROSA	MA.LOURDES	P
SANTIAGO	BERNARD	M
AGUSTIN	MELCHIE	G
FOLLANTE	ROSE	ANN	L
CATAPANG	DONNA	MARIE	R
GARCIA	MADELYN	P
ABE	SATOSHI	M
BERBA	JUAN	ROBERTO	T
DE.LUNA	LADY	PEARL	V
REYES	ERICA	MAE	D
ALVAREZ	JELMARCK	V
BACLIG	GIAN	VIVEZA	C
BALITA	JADE	CESAR	DLC
BAREL	JANBERN	LOPE	A
CABILAN	AIZEL	ARNELLI	C
CHAVIT	PAUL	ALLEN	G
CRISOSTOMO	CHRISTIAN	P
CRUZ	PEARL	DANIELLE	A
ERESE	JOHN	KENNETH	G
ESGUERRA	ROCHELLE	A
HERNANDEZ	ARJANE	B
HILAO	PATRICIA	MARIZ	V
JAVIER	DAN	ERIKA	A
KIM	PAULO	MIGUEL	M
MONTALLANA	MAC	LESON	P
NATIVIDAD	JOANNA	T
PACIA	IRISH	CZARINA	B
POSADAS	GLADYS	VIVIEN	P
RAMEL	EUNICE	VERONICA	O
RECTO	INGRID	A
VACARIZAS	JOSHUA	M
ZAMORA	LORLENE	B
CHOI	JIN	CHEOL
LAUREL	MARGARITA	ANGELA	R
YONZON	DAWA	TSHERING
GERON	FRANCESKA	M
ANDAL	DINNAH	FEYE	H
ABANO	BJ	NAOMI	T
ABCEDE	MIRA	JOY	G
CABURAL	ALYSSA	MARIE	C
GAVAN	CHRISTINE	JOY	T
GONZALES	ZARINA	ROSELLE	S
CRUZ	MARY	JOIE	C
PAULO	KIMBERLY	J
POLICARPIO	ANGELA	MICAH	C
ABUEL	JERICK	JOSEPH	M
PERALTA	AYESZA	CELINE	G
CRUZ	MARIA	KRISTEL	L
BOYBOY	ROSELL	C
ANGGA	MARIJKA	GIACINTA	A
MIRAL	MATTHEW	B
LOPEZ	WENDEL	O
ROXAS	KRIZZIA	JOYCE	D
MACALINAO	CONSTANCE	AURELLE	M
BEDRO	JOSE	RAPHAEL	A
JAMISON	HAZIEL	M
CEGUERRA	KARLA	LOUISE	P
GENECIRAN	MARY	RAE	O
ALMENDRALA	ROSARIO	T
CALAPIT	INGRID	SHANNAH	C
GABILO	MARK	JOVERT	D
ASETRE	LEOREM	KRISHIA	G
CAABAY	MARIA	CECILIA	M
REGALADO	SOFIA	MONICA	B
CARINAN	JOSON	DEXTER	P
MENDOZA	CHRISTIAN	DOMINIC	M
JOSE	KAREN	M
BUGAYON	MARJORIE	E
ADAYO	KENN	T
ADEFUIN	JEIEL	B
CALLEJA	STEPHEN	BRYAN	Y
DELA.CRUZ	KENNETH	BRYAN	DG
SOLDEVILLA	KIM	BENEDICT	B
NOBLE	MEARIC	V
CLARINO	MARC	D
AGCAOILI	MA.GOLDAMAIRE	F
AGDAN	JUAN	MARTHO	C
BARTOLOME	MICHAEL	CEDRIC	B
ARGUELLES	BARBARA	ANNE	DV
CAUDAL	ANGELA	MARIZ	U
CAUDAL	ANGELICA	MARIE	U
LUNA	RAFAEL	III	T
SIMANGAN	BEATRIZ	Q
AGUILA	ROINAND	B
CATUD	MARISOC	M
AHITO	SHALOU	SHALAM	L
SILVA	ANN	MARGARET	M
PASCUAL	GREY-AN	KEITH	P
ALANO	JAMES	JOYCE	G
ALASTOY	JUNE	LANDER	U
FELICIANO	MA.ROXANNE	P
ESPINOLA	MARY	CLAIRE	C
PEREZ	DARWIN	DG
RAMIREZ	RECY	ANN	E
PAMINTUAN	MARY	ANGELINE	Z
ALCACHUPAS	CHRISTINE	ANNE	B
ALCANICES	MONICCA	LORRAINE	M
BALDEMOR	FRANCIS	MIGUEL	C
OLIVO	MARK	ANTHONY	A
DARLUCIO	DANICA	G
CALUBAQUIB	ERIKA	JOY	L
HARION	QUEENNIE	GRACE	L
ALEJO	AVIN	JOYCE	T
QUILLOY	FERGIE	ANN	A
ALFONSO	MARK	M
ALMANZA	DUSTIN	LOREN	V
BRODITH	MARK	DANIEL	L
SANTOALLA	ARIANA	ISABEL	C
QUINAGON	MIRIAM	FRANCESCA	C
INCIONG	JOSE	GIDEON	DC
GAMBOA	INEZ	DOMINIQUE	B
PADILLA	JO	FLORENZ	G
REGALADO	CARMELA	JOY	P
DOMINGO	ABIGAIL	J
GALLENITO	MARC	JOSEPH	F
ONA	KEVIN	AUSTIN	L
MENDOZA	KATRINA	MARIE	E
ENCARNACION	RAFAEL	LUIS	C
ARMILLO	SHARA	JEAN	S
GUTAY	JUWEE	T
GULFAN	CHESSA	DAWN	A
SATIMBRE	CYRIL	V
FELIX	EDD	FRANCIS	O
VERGARA	RHUBY	E
BAQUIRAN	THERESA	LEAN	Z
ARAGUIRANG	GALILEO	E
ALMENARIO	EMMANUEL	B
GUMARANG	PETER	JOHN	I
NAVARRO	ESTHER	LOIS	B
OLAGUER	ANGELINE	N
AMADO	CHRISTIAN	JUDE	T
PARAGGUA	RAIZA	M
AMOLOZA	HAYDELLE	M
ANDORA	ANDREW	P
MANGOSING	MARK	LORENZ	P
SINANG	JOHN	JOSEPH	R
ABRAGAN	MICHELLE	FAYE	A
BACAOCO	KAY	KAREN	P
FARINAS	RENATO	JR	C
APUAN	MARIA	MICHAELA	P
MONTE	SITTIE	HAYNNAH	B
ARTIENDA	LESTER	JAN	K
ARCIAGA	JANEAN	FRANCES	V
AZARCON	STEPHANIE	P
CIELO	JAN	DARYL	E
ANG	ISABELLA	S
EUROPA	LOU	ZENITH	DJ
PALISOC	KAYE	CELINE	P
PUCYUTAN	DIANNE	S
ROSEL	KAREN	KAYE	L
ANQUILO	CAMILLE	DAYANARA	C
AMPARO	TEODORICO	JR	M
CACERES	PAUL	ELESSAR	W
MANUEL	APPLENETTE	APRIL	SJ
BILAN	MICHELLE	KAREN	B
APALLA	KRISTINE	GAZELINE	SJ
BORIDOR	JANZEL	B
FUENTES	JOSEMARIA	M
GUZMAN	LYNDON	JUSTIN	T
CRUZ	ESTHER	JEMIMA	D
MANCHING	TIMOTHY	JAMES	R
ORTEA	MICHELLE	SJ
ABRIGANA	AILA	FAE	L
ARAGON	JERIC	B
PARCON	WILKUS	RAPHAEL	D
REYES	NIKKI	MARIEL	N
SABADO	JOSHUA	JAMES	S
SALVADOR	JOSEPH	PAULO	T
ARAN	CHERRY	MAE	U
TIMBAL	MARICRIS	T
ARATO	FARAH	JANE	A
VILLANUEVA	JOSE	JOAQUIN	R
BONZON	MOLLY	ROSE	M
LEE	MARIE	ANGELINE	L
OCAMPO	CHRYSSA	MICHELLE	R
DAVID	MARIA	TERESA	R
MARQUEZ	ROMMEL	R
ALFILER	JANIKA	P
ANGELES	ELEONOR	JOY	S
ARCILLA	JOSIAH	ISRAEL	F
DELA.CRUZ	HAIEZEL	L
ARQUILADA	ARMAN	LOUI	P
ARRIOLA	JOHAIRA	MAE	T
PAED	JASMIN	E
LUKBAN	HARVEY	M
TANEDO	JODIE	ROSE	G
LAURENCIANO	GINALYN	DS
SALGADO	JOY	MARIE	A
ARTILLAGA	CHERUB	N
LEONARDO	ALEXANDRA	JANE	B
MANAGO	ANNE	MARIEL	DG
CHAVEZ	MINERVA	ANNE	C
ASADA	JEANELLE	GRACE	C
ASEJO	JOHN	BRYAN	DM
HIZOLA	DANICA	CHRISTINE	E
AUSTRIA	JANINE	LARA	O
RAMOS	YNNA	RAZELLE	B
ESCOSIO	JAMIE	JAN	M
GESMUNDO	EIREN	MARIE	B
AVILA	IAN	LIMWELL	B
BAEL	ANGELA	B
ESPANOLA	JOHN	CALEB	G
ECO	RHEY	ANNE	A
FLORES	ARIELLE	MEGAN	A
OLORIS	MIKHAEL	ADRIANNE	R
ORENSE	MC	GIL	I
BANCHIRAN	PAUL	IAN	S
ESPINO	MARIA	BEATRICE	N
VENTURINA	DARREN	H
VERGARA	GIAN	LORENZ	S
LAURE	KATHERINE	JOY	D
GUERRERO	JUDD	EDUARDO	R
GAMIR	AARON	PAUL	B
BANDIAN	INA	PIA	R
BANGALAN	ZYLYNN	F
PASAPORTE	CASSANDRA	BERNADETTE	P
SENORAN	REGINA	SALVE	G
BANGUG	ARISTOTLE	JOSEPH	G
BATILES	MC	ELVIN	S
TALABIS	DYLAN	ANTONIO	SJ
PADUA	KATRINA	NERISSE	C
CATILO	KRISTEL	AMOR	A
RIVERA	KRISTIN	DALE	A
DALANGIN	EUNICE	RAMIEL	F
LEANO	KRIZA	MICKAI	G
ADAJAR	MARIA	AURIELL	DC
BOLIVAR	JUNE	KATHLEEN	G
CALIWAGAN	ANGELIQUE	M
MARANAN	SIENA	CATHERINE	A
BELEN	LOURRAINNE	L
BAUSA	JUAN	RAFAEL	N
ORNILLO	DAWN	LAYA	G
LANDICHO	JOAN	B
BELEN	BABIELYN	C
SEPTIMO	JAYSON	C
GALIPOT	MARIKWELL	V
JAEN	KENDALL	JEANE	G
MENDOZA	CHRISANGEL	B
ORDONEZ	FRANCES	GRACE	N
RAMOS	DIANNE	LOUISE	P
AVERION	FRANZ	REIMART	B
BAUTISTA	ALDRIN	G
BAUTISTA	RICARDO	JR	C
BAYSON	MARIELLE	R
GREGORIO	CYRILLE	ELIZ	C
MISTA	LAZZEL	NATALIA	B
BERNASOL	ALYSSA	MAE	R
DICHOSO	MELISSA	S
BILLONES	FRANZ	JOSEPH	R
CAPILI	RICCA	MAE	B
LUNA	JUAN	EMILIO	M
PERALTA	ERLE	ANGELO	M
TAMARES	SHERRY	ANN	M
ALAIRA	KEVIN	CONRAD	A
VALDEZ	ERNESTO	III	M
SISON	MARC	ALLEN	A
BESIN	CLARICE	ANN	C
BISCOCHO	JEANIE	ROSE	C
FACTOLERIN	WIELSON	M
PARINA	RYAN	REI	C
JAVINAS	EULEAN	B
CALLEJA	JETT	CARLO	C
LABIOS	REUBEN	JACOB	D
VILLAVER	ANNA	VICTORIA	T
MORAN	MALEREINE	JOI	L
MAURICIO	JAMII	ANGELICA	T
MARCHADESCH	MAXINE	NICOLE	M
CAMACHO	APRIL	CHARMAINE	D
CORBITO	KRISTINA	BELEN	P
RELOVA	ANJELINO	A
SAMSON	ROY	NEILSON	R
SANTOS	SUI	GENERIS	P
SIOSON	ERICSON	F
MENEZ	ERIKA	JOAN	R
BITON	ADRIAN	JOHN	A
BOADO	JUSTIN	BERNARD	C
BONDAD	RACHELLE	G
BULAONG	ANNE	BERNARDINE	G
ESPIEL	VERNALEEN	JOYCE	G
SISON	LOVELY	ROWIE	A
DELA.CRUZ	PATRISHA	ANNE	A
LARIOS	ABIGAIL	L
BULATAO	CHARLES	DARWIN	M
SISON	KATHLEEN	LEIGH	E
TAN	SHEILA	MARY	B
BURLAOS	MIRIAM	DC
CAABAY	MICHAEL	JOHN	PDL
OLIVO	LOVELIE	SHAINE	S
GALANG	JONATHAN	ALEXANDER	DJ
AUSTRIA	JONATHAN	DC
CABANATAN	KRISHA	MAE	E
CAISIDO	DANICA	R
DALISAY	KEVIN	ARBINE	M
TORRES	RAMM	KEEGAN	DR
DANS	TOMAS	ENRIQUE	G
CAMPOSANO	ROBIE	V
QUINTOS	MARIA	CARINA	P
CALAMINOS	VIANA	CARLA	C
CALVO	JENIFER	S
CANAVERAL	RONNIE	F	JR
BASILIO	JUDIELYN	JADE	E
CASUGA	DARIUS	JUDE	C
VERGARA	DHANA	RECELLE	DL
FADUL	ANDREI	JAAN	D
OCAMPO	GILLIAN	KRYZLE	C
BARGOLA	RAZELLE	IRA	L
BACLAY	ANN	NICOLE	M
CEBANICO	GIVEN	GRACE	C
PURIFICACION	MARYNOLD	V
LOPEZ	IAN	FERDINAND	L
ORACION	WILLI	MAY	G
CENIDOZA	GEAN	OBVIDENCI	B
HATOL	LOUISE	NICOLE	T
DONASCO	JASMIN	MARIE	L
DALANGIN	APRIL	MAE	DM
PUBLICO	AUDREY	ROSE	L
COMEDIA	JAN	KEVIN	G
DONATO	LUALHATI	M
LARGO	ANNA	RHEA	A
CALLO	SHARMANE	S
BAQUIRAN	MARIA	CLARA	L
NAVASERO	DANIEL	T
CASPILLO	ANGELI	JOCELLE	S
EUSEBIO	MERICK	PAULINE	T
CONSIGNADO	JOANNA	MAY	M
RAQUEL	MERCEGRACE	A
PAPA	JOY	CARMELLA	C
CORDIAL	REILAND	B
CANICULA	JAIME	R
CORTEL	DRIESCH	LUCIEN	R
ROSARIO	LALAINE	M
DIMAILIG	LAWRENCE	ANTHONY	S
GO	MARIE	ALEXANDRINE	A
GALFO	DANDY	JR	C
MACABIDANG	CLAIRE	APRIL	M
BUNI	ALYSSA	MARIE	V
FADRI	ELIZABETH	JOY	A
CRUZ	KEVIN	ALMERT	C
TAN	THERESE	REYSAN	A
PACIS	ROSE	CARMELLI	F
NATIVIDAD	SARAH	ANTOINETTE	B
CUARTEROS	CARMINA	DD
CABATLAO	MA.CHRISTINE	B
CUENCA	MART	GIL	D
DAGUPON	AIMEE	RUTH	I
MENDOZA	MONARD	BIEN	J
APACIBLE	ARAH	CATRINE	B
CARLOS	JIANNE	ROSELLE	M
DE.GUZMAN	ARVIE	CAMILLE	V
DE.LEON	JEROME	P
ROTONI	CELINA	S
PANTE	PRINCESS	P
ALMALVEZ	JONATHAN	M
BERTOS	BERNADETTE	L
DELARMENTE	FAITH	EMERALD	T
DE.OCAMPO	KARLA	SHANE	V
DE.SAGUN	MA.KATHLEA	M
ESTRADA	AYANA	VICTORIA	H
DELA.CRUZ	CHRISTOPHER	DV
DELA.CRUZ	JERICO	S
VERDEJO	CLAUDINE	F
SANDOVAL	KEA	MAE	G
DELA.CRUZ	JIMALENE	ANNE	V
NOCUM	JEN	DAINE	L
SOLIDUM	SARAH	ALLYSSA	S
DELA.CRUZ	PRECIOUS	MAE	A
GARCIA	HANS	GERTH	V
NICOLAS	AMRAPHEL	L
DELICA	CARMELA	DR
ZALDIVAR	JHOWILYN	A
DELLOSA	KRISTINE	GRACE	A
CORTEZ	LUIS	ANGELO	A
DINO	JOSHUA	U
GARCIA	ALLAINE	M
BAJIT	MAHALENE	KRISTINE	R
DIZON	ELAINE	KATHERINE	H
AGUILAR	GELSELMA	F
ANG	NORMAE	D
NUYDA	GABRIELLE	A
SORIANO	TIMOTHY	PAUL	A
OMELDA	LOU	STEFAN	B
LLORIN	MARIA	TRICIA	A
PANLAQUI	DANIELLE	ANNE	N
BAUTISTA	MICHAEL	GILBERT	C
DE.ALDAY	MYLA	C
DOROSAN	MICHAEL	A
LAIG	MARICRIS	DM
CARREON	ERIN	JOYCE	T
BEA	NERISSA	JOYCE	D
MONGE	JERICE	R
DRIO	DONNALYN	L
PANULAYA	BILLY	GEORGE	M
MIRAS	MONALIZA	A
BAYOT	ARIELLE	JANA	F
DUMANDAN	NICO	G
BARTOLAY	ROCHEL	S
ROQUE	RIANNA	JOYCE	P
HERMOGENES	REA	SHANINE	C
TALUSAN	EUGENE	PAUL	E
NAZAR	MICHELLE	ANGELA	M
ECLARIN	NINO	R
EVANGELISTA	ALEXANDRA	MAE	B
GARBO	GEONA	ANGELINE	L
ESCORO	ALVINJOHN	V
VILLALUZ	TRICIA	MARIE	B
ROBLES	DEMI	SARAH	D
CANDIDO	MARIAMA	FRANCINE
BELISTA	JEAN	KARLO	S
ESGUERRA	RANIEL	A
ESTABILLO	MICAELA	E
DAGANDAN	KEILAH	JO	D
GAMBOL	JOHN	CARLOS	A
HUBAG	FRANCINN	MAE	P
PARALEJAS	SHANE	M
SISON	JAN	LESTER	C
ESTAYAN	JOHN	DARREL	P
YAP	REINER	JEFTEE	J
FABROADA	MICAH	B
CRISTOBAL	ANNA	PATRICIA	S
ENDAYA	JEROME	YSRAEL	P
FAMINIAL	ALVIN	FRANZ	O
OLIVAREZ	STEFFI	ROCHE	R
CAPISTRANO	KATHRINE	GRACE	A
FANDIALAN	JOHN	DOMINIC	C
FORMILLEZA	CZARINAH	NICOLE	V
FORNOLES	FLORIFE	B
FUENTES	RENZ	ANDREW	V
TORRELIZA	MARK	ANGELO	H
SISON	RAUL	BENEDICK	A
GALLARDO	LARISE	L
INGALLA	PAULA	CAMILLE	DC
TONGCO	PAMELA	CHRISTA	B
GAMBA	MA.GRAFELLE	G
MAGDANGAN	CHRISTINE	JANE	P
GARCIA	AVERY	JOSEPH	B
PALAD	DOREEN	SARAH	SJ
JAQUIACA	JACQUILYN	ANN	C
MENDOZA	CARL	DAVE	S
GARCIA	FRANCESCA	LOUISE	P
MENDEZ	JOVELYN	M
IRA	ROD	JOHN	O
MASICAP	LADY	EIZEN	O
GERODIAS	MARIE	STELLA	T
NATIVIDAD	ANA	VERONICA	S
ESGUERRA	ALYANNA	MARIE	N
AJUSTO	GENESIS	M
GERONIMO	MARTHA	DENIECE	G
BAGAY	WINDY	LOU	R
BAUTISTA	CHRISTINE	T
GODILANO	DON	NIKO	R
GUIAM	ELLEN	GRACE	A
DELIZO	NESCEAL	S
GUIYAB	ANTONIO	JR	A
HALILI	MA.JADE	G
LAI	KIMBERLY	T
TINGSON	ANNA	LHEA	D
EVANGELISTA	KELVIN	JHON	C
SALAZAR	MARIA	JENICCA	V
NAVIAMOS	JEMIMAH	MAE	F
IGNACIO	MICHAEL	JADE	R
SOLIS	KRISNIEL	FLORENCE	S
PEREZ	FRANCES	ALYANNA	SP
HERNANDEZ	JULIO	MARTIN	P
HERNANDEZ	MARK	BRYAN	F
HERNANDEZ	PATRICK	T
IBABAO	ROCHELLE	P
JALOSJOS	CHARLENE	N
JIMENEZ	CEXZUR	JR	C
JOYA	PAUL	CHRISTOPHER	C
TACCAD	JINNAH	MARIE	G
JOSUE	CHRIS	ANN	M
AUSTRIA	JAMILA	FLAVELLE	S
MAUNGCA	RON	ALDREN	E
JUDLOMAN	JESUS	CESAR	DV
DE.LEON	PAUL	JESHIMON	L
ATIENZA	CAMILLE	MARIE	C
BUGARIN	MARIONE	NICOLE	P
LACHICA	ABIGAEL	MAE	C
ACEDERA	HEXA	DANICA	P
PEREZ	AXEL	ROSS	D
PEREZ	RAISA	DOMINIQUE	G
SALEM	THERESA	NICA	S
JOSE	ROBERTO	JUAN	L
VALDEZ	MARIEL	S
VELASCO	KHRIZHA	T
SEVILLENO	DOLLY	ANN	L
LINDAYAG	MEGI	MAY	C
LEYEZA	MARIA	ENRYK	L
LUSANTA	ARVIE	JOHN	D
TORRE	HANNAH	JANE	T
PLANAS	FRANCES	S
LACIERDA	ALDRICH	C
LACSA	MA.LEIZL	G
BANTAYAN	BRIGETTE	RUTH	H
GALIT	JHONNET	KIM	DG
BAGAMANO	JOSE	ANGELO
FLORES	DAN	PAULO	B
LAGGUI	LORDWIN	G
LEDDA	ROEL	O
GERODIAS	MARIE	HAYDEE	B
TADEO	JENNY	ROSE	J
LIM	JOHN	BRYAN	M
ALO	MEL	GENEVIEVE	SJ
LLANTO	GENE	RYAN	F
PERALTA	KATHLEEN	M
ANINAO	DARYLLE	AYRISH	D
LAGASON	BENJAMIN	III	C
LOPEZ	JULIE	ANN	I
FELONIA	MARK	JAYSON	D
LOPRANDADO	DANALEE	MAE	I
MARZAN	RICARDO	DM
NAVIDA	CHERRYL	MARIE	T
CASTILLO	JESICCA	HANNA	R
BACAY	PATRICIA	ISABEL	B
MACUD	AISHA	J
MADRONIO	JOSHUA	KARL	T
SARMIENTO	EUNICE	P
MAGHIRANG	ANICETO	B	III
MANAHAN	CHRISTIAN	C
MANALANG	VON	GIANELLO	R
MANZANO	FAYE	ANNE	D
MARFORI	CARLO	MARTIN	M
SANTOS	GRAYCEL	E
SAN.JOSE	NAOMI	T
CORPUZ	NEIL	EDUARD	E
BURGOS	VANESSA	JOY	B
PRIMAVERA	MARY	GRACE	M
FUNELAS	KIRSTIE	JOY	P
CACANANDO	CATHERINE	B
CAPUZ	JOSE	IV	R
FAJARDO	LUISA	D
CADELINA	PATRICK	LAWRENCE	P
MARTINEZ	HANNA	CRESENCIALYN	D
BAROTIL	KARINA	JESSICA	E
QUINITA	JERIELY	O
SALANGA	ANGEL	III	C
MAYUGA	EMILY	DG
PALATTAO	CHRISTINE	A
TABARDILLO	JOSELITO	JR	A
KASALA	MARLO	IAN	G
DE.GUZMAN	ALEXANDER	B
MENDOZA	JAMIE	KRIS	B
CLEDERA	SHAUNNAH	YSABEL	V
PURA	PRISCA	E
MANANSALA	STEPHEN	EUNICE	H
MENDOZA	JOHN	EDRICK	B
MERCADO	NADINE	EIRILLE	T
MILANTE	ERIKA	ZAIRA	L
FLORES	KRISHALINDA	MAE	R
MITRA	ERATO	JR	S
MITRAN	KRIZIA	AINA	T
LACATAN	MILCAH	HANNAH	D
ATIENZA	MA.JONNA	A
FABITO	SARAH	JANE	S
MOTEL	BERLYN	M
NEPOMUCENO	GENESSA	E
BAGUNU	CHUNETTE	P
LUIS	LARA	MELISSA	G
OCAMPO	DAVIES	V
ORTEGA	DANIEL	JOSHUA	M
ALDAMA	PRINCE	KENNEX	R
ORTIGUERO	PRINCES	LOU
BALANE	GERALD	JAMES	V
PADILLA	CARMELA	ROXANNE	S
GEMIDA	ELEANOR	B
FELIX	DENIZ	MARIE	G
ROXAS	DANNICA	AGATHA	L
DOLIRO	GLEN	MARK	V
CABALTERA	NYXA	LOUISSE	T
VASQUEZ	BRYAN	DC
PADUA	KIM	RIGOR	S
ATOLE	LIEZEL	DC
PAJARES	MIL	ALRAN	A
PALADO	SEAN	NICOLE	C
BARROGA	ERVIN	M
BERNARDINO	JOFIELYN	G
ESPEDIDO	EMILYN	LOURYN	F
PUREZA	CHERRY	ANN	M
ADDUCUL	RUFUS	THOMAS	Y
CAFUGAUAN	EMELIA	KATRINA	I
FRANCINILLA	TRISEANNE	M
QUIZZAGAN	MARJORIE	B
ABANO	MIKE	ANDREI	P
PALIMA	NEIL-JAN	MATTHEUZ	DJ
ILAO	FRANCES	RAIZA	P
PANTANILLA	DAVID	EPHRAIM	B
ESTINO	RAIZA	J
MORA	JONAH	FELIZA	B
TAGLINAO	JOYCE	ANN	V
SOBERANO	ANGELICA	CAMILLE	T
BATALON	JAMIE	LOUISE	S
CASTILLO	COLLAINE	MARA	V
CINCO	JOAN	PAULINE	U
PELAEZ	LESTER	R
LUBIGAN	JIREH	VIC	DC
REYES	RALPH	ADRIAN	A
SALVAN	AUSTIN	JAPHETH	R
UBALDO	DANIELLE	GRACE	N
PEREZ	CHRISTINE	JOY	M
LONZANO	MARY	CONCEPCION	A
PEREZ	TERESA	ANDREA	DS
EVARISTO	MARYFLOR	DIANTHA	S
PINGA	TRIZIA	MAE	O
CUBERO	ILIOT	KEVIN	L
PLACENTE	CZAR	ZURICH	B
PLUMO	CLOY	DOMINIQUE	T
ELNAR	ALVIN	ANDREW	G
QUEBRAL	ELGIN	PAUL	B
POBOCAN	MARK	ANTHONY	DV
DE.GUZMAN	JEANNA	CHRISELLE	Z
GOMEZ	JOSE	ANGELO	V
SOLIMAN	JILLIAN	MARIE	M
AQUINO	ROBERT	JOHN	A
LACUESTA	FRANCHESKA	MARIE	V
ABLEN	VENICE	REINAFER	B
POTRIDO	KENTUCKY	B
REYES	ANA	CASSANDRA	C
GEDA	JOSE	MARIA	G
REGENCIA	SHARMAINE	L
GRAGASIN	LADYLUCK	JANE	G
ESTEBAN	JERNA	ANGELA	B
ANDAYA	LEONA	KATHLEEN	R
PRIMERO	ROEL	JOHN	C
RODRIGUEZ	RICHES	A
MIRANDA	ERICK	JOSEPH	T
SALE	ZHID	CHRISTIAN	A
BENSAN	ALEXANDRA	A
PULGA	ANGELICA	C
MORENO	JUSTIN	RAYNIER	V
BALDICANA	JEFFREY	B
TOLENTINO	MARK	PAULO	S
QUELISTE	MIYAH	D
WALICAN	JOSE	PAULO	J
ESTRELLADO	DANIEL	P
DALISAY	MARY	JOY	G
ALVINEZ	CHARMAINE	GRACE	C
LOPEZ	PRYNCES	JOYCE	L
RAMOS	JAHZEEL	P
DICHE	CYRIL	T
DELA.CRUZ	SHERMINA	ANNE	DS
REBONG	ANTONETTE	JONELL	T
HERRADURA	DANNA	MARIE	R
PELAYO	ABIGAIL	P
VECINAL	MARICAR	R
CABUYAO	NEIL	FELEO	A
DEL.ROSARIO	ROXANNE	P
PORRAS	CHRISTOPHER
GAYARES	DANICA	MARA	D
REGUYAL	ARIS	JOMEL	B
DELA.CRUZ	PRECIOUS	JOY	N
LAPAZ	JONAH	MARIE	S
REYES	JENNYLYN	L
RELLORA	KARREN	P
RIGONAN	SEVA	MARIE	C
VITTO	ALYSSA	JOY	H
RINOS	JOANNE	MAE	S
SABIO	MAE	SHAANI	S
AGAPITO	KRIZZIA	LYNNE	P
BAYAWA	JEREMIAH	MICAEL	A
NIERE	MANUEL	LESTER	S
CACHO	ANNA	KORINA	H
VIVAS	MA.NIMFA	M
RIVERA	MICHAEL	ANGELO	G
LIM	IRENE	B
ROGERS	JOSE	SIMEON	D
VALGUNA	MARK	DAVID	A
RIZON	KRISTINA	P
NAVESES	RENZES	PEARL	P
ESCOLANO	MARIA	IRENE	L
FLORES	NINNA	BEATRICE	S
BOTIAL	NINA	KARLA	D
PANCHO	JEREMY	G
AGRAVANTE	ELISHA	RIA	C
LUMBA	MANNE	ANDREW	M
ONZA	CARMINE	SARAH	C
ROSALES	MA.MICHAELA	DC
SAAVEDRA	ZENDIE	L
DALAYDAY	JANINE	RICHELLE	M
BORJA	PAUL	JAIRUS	B
SALAS	MARK	C
MILLONDAGA	SIR	EZEKIEL	D
SARMIENTO	ANNE	MARTINE
SALEH	SHADEE	C
ALBA	LINDT	CAMILLE	O
PAJARES	AYESHA	AMMIEL	N
MILAN	ANGELA	MARIEL	C
GONZALES	MA.ROSALIE	M
MASILUNGAN	JUVI	ANNE	M
QUINTO	RIZZA	ANNE	M
AZUL	STEPHEN	EMMANUEL	T
BUSTAMANTE	RIO	CHRISTINE	P
SALIMBAGAT	REY	IV	L
RUANTO	JULLIAN	JIORE	A
ANAIN	JOANNA	MAE	G
SANCHEZ	JHENROVEIR	RHON	T
BASA	MARIANNE	CAMILLE	D
SEECKTS	FRITZ	DERICK	G
BARBERO	CATHERINE	P
QUIZON	REXIE	B
PUNZALAN	EUNICE	RHELEN	G
BANSIL	ELIZABETH	V
SIBAYAN	JASPER	A
CADAY	CARIZZA	MHYRELLE	Z
CALIXTO	MARIE	THERESE	DC
STO	DOMINGO	LOUISE	MINETTE	B
SILVERIO	IMMANUEL	V
VITO	CRUZ	LORENZO	C
BONAYON	MARK	LOUIE	A
DE.VEGA	JOHANN	RICHARDSON	R
SINAGUB	STEPHANE	MATTHEW	K
ORIAS	JACQUELYN	T
BALITA	QUEENIE	ROSE	M
ITOL	MARIEANNE	GR	L
ORTIZ	CARL	PHILIP	M
DAVALOS	APPLE	LYN	G
MANGLICMOT	KAREEN	JOY	B
NATANAUAN	LOVELY	JOY	L
LAUREL	SHAIRMAINE	GEM	M
TANAEL	HAYLEY	T
BANTILES	ANGENETTE	G
SORIANO	KRIZIA	ANN	N
REJUSO	ALEA	MONICA	E
CERVANTES	KERR	A
GONZALES	JONALYN	S
NAYGA	MARY	MADELYNN	I
RAZON	AUDREY	LINETTE	D
SUALLO	ROJHANNIE	E
RAMIREZ	HAZEL	JOYCE	M
MUNCAL	GINA	E
YUZON	EDMUNDS	JR	A
OSIO	CECILLE	ANN	L
OLAGUER	ROSANI	P
GALANG	RHYS	IVAN	L
TAGUSE	MARCK	LORENZ	R
TANCHULING	JES	FRANCIS	M
BATARINA	JERIC	D
VILLA	MARA	ANGELENE	L
DE.MALIGAYA	JENALYN	DP
MONTEGRANDE	KAREN	CLIDE	E
SIA	MANILYN	V
TAPANG	VINCE	ERIC	F
BUCAY	MARK	ANGELO	C
MEDRANO	MICHELLE	ANN	C
DE.CASTRO	CIARA	FIONA	M
ABALOS	LEIDY	LEEN	R
TECSON	MELVIN	JOSEPH	S
TENORIO	EUGENIA	A
TEODORO	ROI	MARC	A
MORALES	ELDHON	M
ESTRELLANA	CYRENE	D
TERNATE	CARLAINE	A
MANRIQUE	ANN	LEXYZ	V
CANOG	RIJI	MAE	T
DIOSO	CLARIZZA	MAY	E
CATAMORA	ARIANE	R
GERES	JOSEPHINE	JOY	R
BONUS	GUADA	MARIE	M
VELINA	JOUBERT	NIEL	C
BERTI	LOVELY	GRACE	M
MANTO	KATRINA	NICOLE	S
DOLOTINA	ALGILYN	P
MOROTA	FRANCIS	MARK	R
TERRADO	ANTONIO	MIGUEL	F
PAGUIRIGAN	NELSON	JR	C
ROSALES	ABIGAIL	JANE	C
TIBAY	NICOLE	I
BAGUNU	ARA	KATHLEEN	M
TIONGSON	MARIJOY	G
TURINGAN	JENNIFER	H
ROJAS	ROMA	CARMELA	B
LIRIO	MARIA	LALAINE	O
GARCIA	JAYSON	F
LUNAS	HEATHER	LOU	C
LAPIE	ANNA	GRACE	P
LEUS	REGIN	C
CAMACHO	KRISTINE	JOY	L
BANAAG	CHRISTIAN	AARON	G
MOSKITO	CARLO	JOSEPH	M
GABOG	KING	BRYAN	C
CARANGUIAN	KIMBERLYNETTE	B
UGAY	MARIA	LOURDES	R
FELIPE	KEVIN	VINCENT	D
LAJARA	NORLY	B
HAJIM	MARSHERY	H
URI	EVAN	RAE	R
RONOLO	SYLVIA	CHRISTINE	M
TRESVALLES	KRIS	G
LOPEZ	LYEKA	M
ONIA	CHELSEA	ANGELA	M
ABADILLA	MOSES	EDRIC	G
DY	ERICKAH	THERESE	R
CURA	MARIS	HAZEL	A
DIONORA	JOSE	MIGUEL	A
GENDRANO	PAMELA	JASMIN	M
MAMARIL	HIYASMIN	S
PANERIO	RAFAEL	JULIAN	G
VARGAS	PEDRO	EMMANUEL	P
ALBAJERA	KISSHA	H
VALENTIN	KRISTELA	MAE-JOY	R
LABACO	BENEDICK	B
DELA.ROSA	AMIEL	D
SANCHO	CHRISTINE	MELISSA	A
CASTRO	ACE	R
VALENZUELA	MELISSA	A
VERANO	KYRELL	VANN	B
AYEN	CARL	JOHNJAY	A
DOGAOJO	JESSICA	DJ
PASCUAL	CHRISTINE	T
CRUZAT	CRIS	ADRIAN	P
SELVA	NEIL	GABRIEL	C
LAGUDA	JULIET	FE	J
ENDENCIA	JOAN	ANGELICA	O
VELONZA	ROWELL	B
CALAUAD	KAREN	ANN	C
DELA.CRUZ	GIAN	PAULO	L
FADRI	JARA	WAYNNE	M
VENTOCILLA	FRANCES	CAMILLE
PUNELAS	DANA	C
DELIVA	FATIMA	G
VENTURINA	LOUELA	T
TUBIJE	DESIREE	JOY	B
VERAYIN	WILBERT	G
RASALAN	JOSEPH	B
DATUIN	CAMILLE	ELIZE	F
MACAM	GENNEVIEVE	M
ABESAMIS	ALTHEA	DESSA	T
AGUIRRE	ERIKA	MARIANNE	H
BALAIS	ANGELA	I
DE.CASTRO	MICHAELA	M
DIMAGIBA	MA.LOTUSLEI	P
FRASCO	ERIK	JOHN	F
ROQUE	SARAH	M
SALAZAR	JEANELLE	Q
SAPLAN	MARIA	LUISA	C
PANTE	MA.LAURELYN	P
LANTICAN	JOHN	OSLEC	Q
VILLAMOR	IAN	O
VILLEGAS	SAMUEL	III	S
VIRAY	KIMBERLY	JOY	V
YANTO	JAN	ARKIM	M
SATORE	LEO	FRANCIS	M
BOLTIADOR	CHARISSE	MARIE	A
KIM	SHO	HUN
MENESES	CAMILA	G
PEA	PHILIP	NICOLE	C
SAGUINDAN	HAZIEL	A
CABAUATAN	FIONA	MARIA	C
MEDIALDEA	ARIANE	E
MERLAN	NATALIE	B
ZERRUDO	STEPHANEE	JOY	B
BADRINA	REX	DAVID	C
BIENES	KRISTINA	MAE	U
RAREZA	HERSHEY	JUNE	G
SANCHEZ	ZORELL	JOHN	U
LUCERO	REY	PAOLO	G
QUILNAT	MARIE	PAZ	L
